aastane	omadussõna	A2
aastapäev	nimisõna	A2
abielluma	tegusõna	A2
abielu	nimisõna	A2
abielus	määrsõna	A2
abil	kaassõna	A2
aeg-ajalt	määrsõna	A2
ahjukartulid	nimisõna	A2
aine	nimisõna	A2
ajakiri	nimisõna	A2
ajakirjandus	nimisõna	A2
ajakirjanik	nimisõna	A2
ajaleht	nimisõna	A2
ajalugu	nimisõna	A2
ajama	tegusõna	A2
aktiivne	omadussõna	A2
ala	nimisõna	A2
alates	kaassõna	A2
album	nimisõna	A2
alkohol	nimisõna	A2
allkiri	nimisõna	A2
alt	määrsõna	A2
alumine	omadussõna	A2
aluspüksid	nimisõna	A2
ameeriklane	nimisõna	A2
amet	nimisõna	A2
ammu	määrsõna	A2
analüüs	nimisõna	A2
ananass	nimisõna	A2
andmed	nimisõna	A2
ansambel	nimisõna	A2
apelsinimahl	nimisõna	A2
areng	nimisõna	A2
arhitekt	nimisõna	A2
armas	omadussõna	A2
artikkel	nimisõna	A2
arutama	tegusõna	A2
arvamus	nimisõna	A2
arve	nimisõna	A2
arvutimäng	nimisõna	A2
auk	nimisõna	A2
aus	omadussõna	A2
ausalt	määrsõna	A2
autojuht	nimisõna	A2
autor	nimisõna	A2
avaldus	nimisõna	A2
avama	tegusõna	A2
avarii	nimisõna	A2
baar	nimisõna	A2
beež	omadussõna	A2
bensiinijaam	nimisõna	A2
bussijaam	nimisõna	A2
bussijuht	nimisõna	A2
bussipilet	nimisõna	A2
bänd	nimisõna	A2
daam	nimisõna	A2
detail	nimisõna	A2
doktor	nimisõna	A2
dokument	nimisõna	A2
dressid	nimisõna	A2
džemper	nimisõna	A2
dušigeel	nimisõna	A2
dušinurk	nimisõna	A2
e-kiri	nimisõna	A2
e-post	nimisõna	A2
ebameeldiv	omadussõna	A2
edu	nimisõna	A2
eelistus	nimisõna	A2
eemal	määrsõna	A2
eesmärk	nimisõna	A2
eestikeelne	omadussõna	A2
ega	määrsõna	A2
ega	sidesõna	A2
ehitaja	nimisõna	A2
ehitus	nimisõna	A2
ehk	määrsõna	A2
ehk	sidesõna	A2
ekraan	nimisõna	A2
eks	määrsõna	A2
eksam	nimisõna	A2
ekskursioon	nimisõna	A2
elamisluba	nimisõna	A2
elanik	nimisõna	A2
elekter	nimisõna	A2
elukoht	nimisõna	A2
elus	omadussõna	A2
elutuba	nimisõna	A2
enam	määrsõna	A2
energia	nimisõna	A2
eraldi	määrsõna	A2
eri	omadussõna	A2
eriala	nimisõna	A2
eriline	omadussõna	A2
eriti	määrsõna	A2
esik	nimisõna	A2
esinema	tegusõna	A2
etapp	nimisõna	A2
ettekandja	nimisõna	A2
ettekanne	nimisõna	A2
ettepanek	nimisõna	A2
ettevaatlik	omadussõna	A2
ettevõte	nimisõna	A2
fakt	nimisõna	A2
festival	nimisõna	A2
fond	nimisõna	A2
forell	nimisõna	A2
fotoaparaat	nimisõna	A2
fotograaf	nimisõna	A2
föön	nimisõna	A2
gaas	nimisõna	A2
garantii	nimisõna	A2
garderoob	nimisõna	A2
greip	nimisõna	A2
gümnaasium	nimisõna	A2
habe	nimisõna	A2
haige	nimisõna	A2
haigeks jääma	tegusõna	A2
haigla	nimisõna	A2
haigus	nimisõna	A2
hakkliha	nimisõna	A2
hall	nimisõna	A2
halvasti	määrsõna	A2
hambahari	nimisõna	A2
hambapasta	nimisõna	A2
hambavalu	nimisõna	A2
hamburger	nimisõna	A2
hani	nimisõna	A2
hapukurk	nimisõna	A2
hari	nimisõna	A2
haridus	nimisõna	A2
harjutus	nimisõna	A2
hiir	nimisõna	A2
hiljaks jääma	tegusõna	A2
hiljem	määrsõna	A2
hindama	tegusõna	A2
hing	nimisõna	A2
hingama	tegusõna	A2
hobi	nimisõna	A2
hobune	nimisõna	A2
hoidma	tegusõna	A2
hommikune	omadussõna	A2
hommikusöök	nimisõna	A2
hooaeg	nimisõna	A2
hoolitsema	tegusõna	A2
hoone	nimisõna	A2
hotell	nimisõna	A2
hulgas	kaassõna	A2
hulk	nimisõna	A2
hulka	kaassõna	A2
hunt	nimisõna	A2
huul	nimisõna	A2
huvitama	tegusõna	A2
hõbedane	omadussõna	A2
häda	nimisõna	A2
hädaabi	nimisõna	A2
hüppama	tegusõna	A2
ida	nimisõna	A2
igapäevane	omadussõna	A2
igasugune	asesõna	A2
igav	omadussõna	A2
igaüks	asesõna	A2
ikkagi	määrsõna	A2
ilves	nimisõna	A2
imelik	omadussõna	A2
ingel	nimisõna	A2
inglane	nimisõna	A2
ingliskeelne	omadussõna	A2
insener	nimisõna	A2
intervjuu	nimisõna	A2
iseloom	nimisõna	A2
isiklik	omadussõna	A2
jaam	nimisõna	A2
jaanipäev	nimisõna	A2
jagama	tegusõna	A2
jahe	omadussõna	A2
jahu	nimisõna	A2
jala	määrsõna	A2
jalaluu	nimisõna	A2
jalanõu	nimisõna	A2
jalgrattur	nimisõna	A2
jalgsi	määrsõna	A2
jalutama	tegusõna	A2
joogivesi	nimisõna	A2
jook	nimisõna	A2
joon	nimisõna	A2
joonistama	tegusõna	A2
jope	nimisõna	A2
juhataja	nimisõna	A2
juhatama	tegusõna	A2
juhatus	nimisõna	A2
juhiluba	nimisõna	A2
juht	nimisõna	A2
juhtima	tegusõna	A2
juhtuma	tegusõna	A2
julge	omadussõna	A2
julgema	tegusõna	A2
jumal	nimisõna	A2
jurist	nimisõna	A2
jutustama	tegusõna	A2
juubel	nimisõna	A2
juurvili	nimisõna	A2
juut	nimisõna	A2
jõud	nimisõna	A2
jõudma	tegusõna	A2
jõulud	nimisõna	A2
jänes	nimisõna	A2
järel	määrsõna	A2
järel	kaassõna	A2
järele	kaassõna	A2
järgi	määrsõna	A2
järjekord	nimisõna	A2
jätkama	tegusõna	A2
jätma	tegusõna	A2
jääma	tegusõna	A2
kaal	nimisõna	A2
kaaluma	tegusõna	A2
kaamera	nimisõna	A2
kaasas	määrsõna	A2
kabinet	nimisõna	A2
kaduma	tegusõna	A2
kael	nimisõna	A2
kaheksakümnes	järgarvsõna	A2
kaheksateistkümnes	järgarvsõna	A2
kahekümnes	järgarvsõna	A2
kaheteistkümnes	järgarvsõna	A2
kahju	nimisõna	A2
kahjuks	määrsõna	A2
kaitse	nimisõna	A2
kaitsma	tegusõna	A2
kalender	nimisõna	A2
kalkun	nimisõna	A2
kallas	nimisõna	A2
kalmistu	nimisõna	A2
kamm	nimisõna	A2
kammima	tegusõna	A2
kampaania	nimisõna	A2
kampsun	nimisõna	A2
kanaliha	nimisõna	A2
kandidaat	nimisõna	A2
kandma	tegusõna	A2
kaotama	tegusõna	A2
karp	nimisõna	A2
kartma	tegusõna	A2
karu	nimisõna	A2
kassa	nimisõna	A2
kassipoeg	nimisõna	A2
kast	nimisõna	A2
kaste	nimisõna	A2
kasu	nimisõna	A2
kasulik	omadussõna	A2
kasv	nimisõna	A2
kasvataja	nimisõna	A2
kasvatama	tegusõna	A2
katastroof	nimisõna	A2
katki	määrsõna	A2
katki minema	tegusõna	A2
katki tegema	tegusõna	A2
katus	nimisõna	A2
kauge	omadussõna	A2
kaugel	määrsõna	A2
kaugele	määrsõna	A2
kaugelt	määrsõna	A2
kaunis	omadussõna	A2
kaup	nimisõna	A2
kauss	nimisõna	A2
kava	nimisõna	A2
keegi	asesõna	A2
keerama	tegusõna	A2
keeruline	omadussõna	A2
keetma	tegusõna	A2
keha	nimisõna	A2
kehaosa	nimisõna	A2
kelder	nimisõna	A2
kena	omadussõna	A2
kera	nimisõna	A2
keskaegne	omadussõna	A2
keskele	kaassõna	A2
kesklinn	nimisõna	A2
keskmiselt	määrsõna	A2
keskus	nimisõna	A2
kestma	tegusõna	A2
kiirabi	nimisõna	A2
kiire	omadussõna	A2
kiirelt	määrsõna	A2
kiiremini	määrsõna	A2
kiitma	tegusõna	A2
kilekott	nimisõna	A2
kilomeeter	nimisõna	A2
king	nimisõna	A2
kingitus	nimisõna	A2
kinkima	tegusõna	A2
kinnas	nimisõna	A2
kirik	nimisõna	A2
kirjandus	nimisõna	A2
kirjanik	nimisõna	A2
kirjeldama	tegusõna	A2
kirju	omadussõna	A2
kirjutuslaud	nimisõna	A2
kirsipuu	nimisõna	A2
kirss	nimisõna	A2
klassikaline	omadussõna	A2
klaviatuur	nimisõna	A2
kleit	nimisõna	A2
klubi	nimisõna	A2
kodakondsus	nimisõna	A2
kodumaa	nimisõna	A2
kodune	omadussõna	A2
kogu	nimisõna	A2
koguma	tegusõna	A2
kohta	kaassõna	A2
kohtumine	nimisõna	A2
kohuke	nimisõna	A2
kohvikoor	nimisõna	A2
kohvimasin	nimisõna	A2
kokakoola	nimisõna	A2
kokk	nimisõna	A2
kokteil	nimisõna	A2
kolima	tegusõna	A2
kolleeg	nimisõna	A2
kolmekümnes	järgarvsõna	A2
kolmeteistkümnes	järgarvsõna	A2
komisjon	nimisõna	A2
komm	nimisõna	A2
kommentaar	nimisõna	A2
kompott	nimisõna	A2
konflikt	nimisõna	A2
konkreetne	omadussõna	A2
konkurents	nimisõna	A2
konkurss	nimisõna	A2
konn	nimisõna	A2
kontakt	nimisõna	A2
kontor	nimisõna	A2
kontroll	nimisõna	A2
kontrollima	tegusõna	A2
konverents	nimisõna	A2
koopia	nimisõna	A2
koor	nimisõna	A2
koostöö	nimisõna	A2
kordama	tegusõna	A2
kordamine	nimisõna	A2
korjama	tegusõna	A2
korralik	omadussõna	A2
korras	määrsõna	A2
korv	nimisõna	A2
kraad	nimisõna	A2
kraan	nimisõna	A2
kruus	nimisõna	A2
kuiv	omadussõna	A2
kukkuma	tegusõna	A2
kuldne	omadussõna	A2
kummik	nimisõna	A2
kunagi	määrsõna	A2
kuningas	nimisõna	A2
kunst	nimisõna	A2
kunstikool	nimisõna	A2
kunstnik	nimisõna	A2
kurb	omadussõna	A2
kurguvalu	nimisõna	A2
kuri	omadussõna	A2
kurss	nimisõna	A2
kursus	nimisõna	A2
kutsuma	tegusõna	A2
kuuekümnes	järgarvsõna	A2
kuueteistkümnes	järgarvsõna	A2
kuulamine	nimisõna	A2
kuuluma	tegusõna	A2
kuulus	omadussõna	A2
kuulutama	tegusõna	A2
kuulutus	nimisõna	A2
kuum	omadussõna	A2
kuusk	nimisõna	A2
kõhn	omadussõna	A2
kõhuvalu	nimisõna	A2
kõigepealt	määrsõna	A2
kõndima	tegusõna	A2
kõne	nimisõna	A2
kõnelema	tegusõna	A2
kõrge	omadussõna	A2
kõrgus	nimisõna	A2
kõrvavalu	nimisõna	A2
käituma	tegusõna	A2
käterätik	nimisõna	A2
käärid	nimisõna	A2
köögivili	nimisõna	A2
küla	nimisõna	A2
külaline	nimisõna	A2
külastama	tegusõna	A2
külmik	nimisõna	A2
külmkapp	nimisõna	A2
küpsis	nimisõna	A2
küte	nimisõna	A2
kütma	tegusõna	A2
kütus	nimisõna	A2
küüslauk	nimisõna	A2
laelamp	nimisõna	A2
laen	nimisõna	A2
lahendus	nimisõna	A2
lahutama	tegusõna	A2
lahutatud	omadussõna	A2
lammas	nimisõna	A2
langema	tegusõna	A2
lapsevanem	nimisõna	A2
lasteaed	nimisõna	A2
lastehaigla	nimisõna	A2
laualamp	nimisõna	A2
lauamäng	nimisõna	A2
laulja	nimisõna	A2
lause	nimisõna	A2
lava	nimisõna	A2
leedu	käändumatu omadussõna	A2
legend	nimisõna	A2
lehekülg	nimisõna	A2
lehm	nimisõna	A2
lemmikloom	nimisõna	A2
lennujaam	nimisõna	A2
lennupilet	nimisõna	A2
lennuväli	nimisõna	A2
leping	nimisõna	A2
leppima	tegusõna	A2
lift	nimisõna	A2
liige	nimisõna	A2
liin	nimisõna	A2
liit	nimisõna	A2
liitma	tegusõna	A2
lilla	omadussõna	A2
lipp	nimisõna	A2
lips	nimisõna	A2
lisa	nimisõna	A2
lisainfo	nimisõna	A2
lisama	tegusõna	A2
looma	tegusõna	A2
loomaaed	nimisõna	A2
loomaarst	nimisõna	A2
lootma	tegusõna	A2
loss	nimisõna	A2
luba	nimisõna	A2
lubadus	nimisõna	A2
lugemissaal	nimisõna	A2
lugupeetud	omadussõna	A2
luu	nimisõna	A2
lõbus	omadussõna	A2
lõhe	nimisõna	A2
lõhn	nimisõna	A2
lõikama	tegusõna	A2
lõpuks	määrsõna	A2
läbi lugema	tegusõna	A2
lähedal	määrsõna	A2
lähedal	kaassõna	A2
lähedale	määrsõna	A2
lähedale	kaassõna	A2
läti	käändumatu omadussõna	A2
lätlane	nimisõna	A2
lääs	nimisõna	A2
lööma	tegusõna	A2
maa-ala	nimisõna	A2
maakond	nimisõna	A2
maal	nimisõna	A2
maantee	nimisõna	A2
madal	omadussõna	A2
magamistuba	nimisõna	A2
magus	omadussõna	A2
magustoit	nimisõna	A2
maha	määrsõna	A2
maitsev	omadussõna	A2
majandus	nimisõna	A2
majonees	nimisõna	A2
makaron	nimisõna	A2
makse	nimisõna	A2
mari	nimisõna	A2
mark	nimisõna	A2
mask	nimisõna	A2
materjal	nimisõna	A2
meeleolu	nimisõna	A2
meeskond	nimisõna	A2
meil	nimisõna	A2
meister	nimisõna	A2
meremees	nimisõna	A2
mesi	nimisõna	A2
metall	nimisõna	A2
mikrolaineahi	nimisõna	A2
milleks	määrsõna	A2
millimeeter	nimisõna	A2
minevik	nimisõna	A2
mingi	asesõna	A2
ministeerium	nimisõna	A2
miski	asesõna	A2
mitmes	asesõna	A2
mobiil	nimisõna	A2
moment	nimisõna	A2
mood	nimisõna	A2
moos	nimisõna	A2
mootor	nimisõna	A2
mootorratas	nimisõna	A2
mudel	nimisõna	A2
mure	nimisõna	A2
muretsema	tegusõna	A2
muu	asesõna	A2
muuseum	nimisõna	A2
muusikakool	nimisõna	A2
muutma	tegusõna	A2
muutuma	tegusõna	A2
muutus	nimisõna	A2
mõjuma	tegusõna	A2
mõjutama	tegusõna	A2
mõni	asesõna	A2
mõnikord	määrsõna	A2
mäletama	tegusõna	A2
mälu	nimisõna	A2
mäng	nimisõna	A2
mängija	nimisõna	A2
mänguasi	nimisõna	A2
märg	omadussõna	A2
märk	nimisõna	A2
märkama	tegusõna	A2
mööda	kaassõna	A2
müsli	nimisõna	A2
müts	nimisõna	A2
müük	nimisõna	A2
naaber	nimisõna	A2
naeratama	tegusõna	A2
naeratus	nimisõna	A2
nagu	määrsõna	A2
nahk	nimisõna	A2
naljakas	omadussõna	A2
nartsiss	nimisõna	A2
natukene	määrsõna	A2
negatiivne	omadussõna	A2
neiu	nimisõna	A2
neljakümnes	järgarvsõna	A2
neljateistkümnes	järgarvsõna	A2
nelk	nimisõna	A2
niisugune	asesõna	A2
nimekiri	nimisõna	A2
nimetama	tegusõna	A2
noor	nimisõna	A2
norm	nimisõna	A2
normaalne	omadussõna	A2
nukk	nimisõna	A2
nõudepesumasin	nimisõna	A2
nõus olema	tegusõna	A2
näide	nimisõna	A2
näiteks	määrsõna	A2
näitleja	nimisõna	A2
objekt	nimisõna	A2
oht	nimisõna	A2
olukord	nimisõna	A2
omanik	nimisõna	A2
omavahel	määrsõna	A2
omlett	nimisõna	A2
onunaine	nimisõna	A2
onupoeg	nimisõna	A2
onutütar	nimisõna	A2
oranž	omadussõna	A2
orav	nimisõna	A2
organisatsioon	nimisõna	A2
organiseerima	tegusõna	A2
orkester	nimisõna	A2
osa võtma	tegusõna	A2
osakond	nimisõna	A2
osalema	tegusõna	A2
oskus	nimisõna	A2
ost	nimisõna	A2
ostja	nimisõna	A2
ots	nimisõna	A2
otse	määrsõna	A2
otsus	nimisõna	A2
otsustama	tegusõna	A2
paha	omadussõna	A2
paik	nimisõna	A2
pakk	nimisõna	A2
pakkima	tegusõna	A2
palav	omadussõna	A2
palk	nimisõna	A2
palve	nimisõna	A2
pangaarve	nimisõna	A2
pangaautomaat	nimisõna	A2
pangakaart	nimisõna	A2
pank	nimisõna	A2
pann	nimisõna	A2
pannkook	nimisõna	A2
paraad	nimisõna	A2
parandama	tegusõna	A2
parem	määrsõna	A2
paremal	määrsõna	A2
paremale	määrsõna	A2
paremini	määrsõna	A2
parkla	nimisõna	A2
part	nimisõna	A2
partii	nimisõna	A2
partner	nimisõna	A2
patsient	nimisõna	A2
peaaegu	määrsõna	A2
pealt	määrsõna	A2
pealt	kaassõna	A2
peamine	omadussõna	A2
peatuma	tegusõna	A2
peavalu	nimisõna	A2
pedagoog	nimisõna	A2
peegel	nimisõna	A2
peet	nimisõna	A2
pehme	omadussõna	A2
pension	nimisõna	A2
pensionär	nimisõna	A2
perearst	nimisõna	A2
peremees	nimisõna	A2
perenaine	nimisõna	A2
periood	nimisõna	A2
pesa	nimisõna	A2
pesu	nimisõna	A2
pesumasin	nimisõna	A2
pidama	tegusõna	A2
pidevalt	määrsõna	A2
pidžaama	nimisõna	A2
pidulik	omadussõna	A2
piir	nimisõna	A2
piirkond	nimisõna	A2
pilves	omadussõna	A2
pilves	määrsõna	A2
pime	omadussõna	A2
pintsak	nimisõna	A2
pipar	nimisõna	A2
piparkook	nimisõna	A2
pirnipuu	nimisõna	A2
pisut	määrsõna	A2
pitsa	nimisõna	A2
plats	nimisõna	A2
pliit	nimisõna	A2
ploom	nimisõna	A2
ploomipuu	nimisõna	A2
pluus	nimisõna	A2
poliitik	nimisõna	A2
poliitika	nimisõna	A2
politseinik	nimisõna	A2
pool	kaassõna	A2
poole	kaassõna	A2
pooleli	määrsõna	A2
poolt	kaassõna	A2
poolteist	põhiarvsõna	A2
popkorn	nimisõna	A2
populaarne	omadussõna	A2
positiivne	omadussõna	A2
post	nimisõna	A2
postkaart	nimisõna	A2
postkast	nimisõna	A2
postkontor	nimisõna	A2
pott	nimisõna	A2
praam	nimisõna	A2
praegune	omadussõna	A2
praktika	nimisõna	A2
prantslane	nimisõna	A2
prantsuse	käändumatu omadussõna	A2
preemia	nimisõna	A2
president	nimisõna	A2
prillid	nimisõna	A2
probleem	nimisõna	A2
professor	nimisõna	A2
programm	nimisõna	A2
projekt	nimisõna	A2
proov	nimisõna	A2
proovima	tegusõna	A2
protsent	nimisõna	A2
protsess	nimisõna	A2
publik	nimisõna	A2
puder	nimisõna	A2
puhkepäev	nimisõna	A2
puuvili	nimisõna	A2
põder	nimisõna	A2
põhi	nimisõna	A2
põhi	nimisõna	A2
põhiline	omadussõna	A2
põhimõte	nimisõna	A2
põhjus	nimisõna	A2
põlema	tegusõna	A2
põlv	nimisõna	A2
põnev	omadussõna	A2
päevik	nimisõna	A2
pähkel	nimisõna	A2
pärast	määrsõna	A2
päris	määrsõna	A2
päästma	tegusõna	A2
pöörama	tegusõna	A2
pöörduma	tegusõna	A2
püha	nimisõna	A2
püksid	nimisõna	A2
püree	nimisõna	A2
püüdma	tegusõna	A2
raam	nimisõna	A2
raamatukogu	nimisõna	A2
rahakott	nimisõna	A2
rahu	nimisõna	A2
rahul olema	tegusõna	A2
rahulik	omadussõna	A2
rahulikult	määrsõna	A2
rahvus	nimisõna	A2
rand	nimisõna	A2
raudtee	nimisõna	A2
raudteejaam	nimisõna	A2
ravi	nimisõna	A2
ravima	tegusõna	A2
reaalne	omadussõna	A2
rebane	nimisõna	A2
redis	nimisõna	A2
registreerima	tegusõna	A2
reis	nimisõna	A2
reisima	tegusõna	A2
remont	nimisõna	A2
režissöör	nimisõna	A2
rida	nimisõna	A2
riidesse panema	tegusõna	A2
riik	nimisõna	A2
riiul	nimisõna	A2
rikas	omadussõna	A2
rind	nimisõna	A2
ring	nimisõna	A2
risk	nimisõna	A2
rist	nimisõna	A2
rohi	nimisõna	A2
roll	nimisõna	A2
rongijaam	nimisõna	A2
rongipilet	nimisõna	A2
roos	nimisõna	A2
roosa	omadussõna	A2
rootsi	käändumatu omadussõna	A2
rootslane	nimisõna	A2
rott	nimisõna	A2
rubla	nimisõna	A2
ruttu	määrsõna	A2
rõõm	nimisõna	A2
rõõmus	omadussõna	A2
rõõmustama	tegusõna	A2
rühm	nimisõna	A2
saabas	nimisõna	A2
saabuma	tegusõna	A2
saade	nimisõna	A2
saal	nimisõna	A2
saar	nimisõna	A2
saatma	tegusõna	A2
sadam	nimisõna	A2
sageli	määrsõna	A2
sajand	nimisõna	A2
sajas	järgarvsõna	A2
saksakeelne	omadussõna	A2
sakslane	nimisõna	A2
sall	nimisõna	A2
samasugune	asesõna	A2
samm	nimisõna	A2
samuti	määrsõna	A2
sarnane	omadussõna	A2
saun	nimisõna	A2
seadus	nimisõna	A2
sealiha	nimisõna	A2
seas	kaassõna	A2
seelik	nimisõna	A2
seep	nimisõna	A2
seest	määrsõna	A2
seest	kaassõna	A2
segama	tegusõna	A2
seitsmekümnes	järgarvsõna	A2
seitsmeteistkümnes	järgarvsõna	A2
seks	nimisõna	A2
sekund	nimisõna	A2
selgelt	määrsõna	A2
seljakott	nimisõna	A2
seljavalu	nimisõna	A2
selts	nimisõna	A2
seltskond	nimisõna	A2
seminar	nimisõna	A2
seni	määrsõna	A2
sentimeeter	nimisõna	A2
sidrunimahl	nimisõna	A2
siga	nimisõna	A2
signaal	nimisõna	A2
siil	nimisõna	A2
siiski	määrsõna	A2
silt	nimisõna	A2
sinep	nimisõna	A2
sink	nimisõna	A2
sisse lülitama	tegusõna	A2
sissepääs	nimisõna	A2
situatsioon	nimisõna	A2
sokk	nimisõna	A2
sooduspilet	nimisõna	A2
soomlane	nimisõna	A2
soovitama	tegusõna	A2
soovitus	nimisõna	A2
sort	nimisõna	A2
sotsiaalne	omadussõna	A2
spaa	nimisõna	A2
spetsiaalne	omadussõna	A2
spetsialist	nimisõna	A2
spordikool	nimisõna	A2
sport	nimisõna	A2
sugu	nimisõna	A2
suits	nimisõna	A2
sukkpüksid	nimisõna	A2
sulgema	tegusõna	A2
summa	nimisõna	A2
supermarket	nimisõna	A2
suss	nimisõna	A2
suurepärane	omadussõna	A2
suurus	nimisõna	A2
suusataja	nimisõna	A2
suusk	nimisõna	A2
suutma	tegusõna	A2
sviiter	nimisõna	A2
sõbralik	omadussõna	A2
sõbranna	nimisõna	A2
sõda	nimisõna	A2
sõiduk	nimisõna	A2
sõidukaart	nimisõna	A2
sõidutee	nimisõna	A2
sõit	nimisõna	A2
sõltuma	tegusõna	A2
sõnum	nimisõna	A2
sõrm	nimisõna	A2
särk	nimisõna	A2
süda	nimisõna	A2
sügav	omadussõna	A2
sülearvuti	nimisõna	A2
sümbol	nimisõna	A2
sündmus	nimisõna	A2
sünniaasta	nimisõna	A2
süsteem	nimisõna	A2
šampoon	nimisõna	A2
šašlõkk	nimisõna	A2
T-särk	nimisõna	A2
tabel	nimisõna	A2
taha	määrsõna	A2
taha	kaassõna	A2
tahvelarvuti	nimisõna	A2
taksojuht	nimisõna	A2
talu	nimisõna	A2
tarkus	nimisõna	A2
tase	nimisõna	A2
tasku	nimisõna	A2
tasu	nimisõna	A2
tasuline	omadussõna	A2
tasuma	tegusõna	A2
tasuta	määrsõna	A2
tavaliselt	määrsõna	A2
teade	nimisõna	A2
teatama	tegusõna	A2
teema	nimisõna	A2
tegelema	tegusõna	A2
tegevus	nimisõna	A2
tegija	nimisõna	A2
tehas	nimisõna	A2
tehnika	nimisõna	A2
tehniline	omadussõna	A2
teine	asesõna	A2
teineteise	asesõna	A2
teksad	nimisõna	A2
telefonikõne	nimisõna	A2
telekas	nimisõna	A2
teler	nimisõna	A2
tellima	tegusõna	A2
tellimus	nimisõna	A2
tempo	nimisõna	A2
terav	omadussõna	A2
territoorium	nimisõna	A2
tervislik	omadussõna	A2
tervitama	tegusõna	A2
toiduaine	nimisõna	A2
tonn	nimisõna	A2
torm	nimisõna	A2
toru	nimisõna	A2
traditsioon	nimisõna	A2
traditsiooniline	omadussõna	A2
treener	nimisõna	A2
treening	nimisõna	A2
trenn	nimisõna	A2
trepp	nimisõna	A2
trikk	nimisõna	A2
tudeng	nimisõna	A2
tugitool	nimisõna	A2
tuhandes	järgarvsõna	A2
tulekahju	nimisõna	A2
tulema	tegusõna	A2
tulemus	nimisõna	A2
tuletõrje	nimisõna	A2
tulevik	nimisõna	A2
tulp	nimisõna	A2
tunne	nimisõna	A2
turist	nimisõna	A2
turniir	nimisõna	A2
tuttav	nimisõna	A2
tuttav	omadussõna	A2
tutvuma	tegusõna	A2
tõesti	määrsõna	A2
tõlge	nimisõna	A2
tõlkima	tegusõna	A2
tõmbama	tegusõna	A2
tõsi	nimisõna	A2
tõsine	omadussõna	A2
tõstma	tegusõna	A2
tõttu	kaassõna	A2
tädimees	nimisõna	A2
tädipoeg	nimisõna	A2
täditütar	nimisõna	A2
tähele panema	tegusõna	A2
tähelepanu	nimisõna	A2
tähistama	tegusõna	A2
tähtis	omadussõna	A2
täis	omadussõna	A2
täis	määrsõna	A2
täitma	tegusõna	A2
tänama	tegusõna	A2
tänane	omadussõna	A2
tänu	nimisõna	A2
tänu	kaassõna	A2
täpne	omadussõna	A2
täpselt	määrsõna	A2
töökoht	nimisõna	A2
tööline	nimisõna	A2
tööpäev	nimisõna	A2
töötaja	nimisõna	A2
töötu	nimisõna	A2
töötu	omadussõna	A2
tühi	omadussõna	A2
uhke	omadussõna	A2
umbes	määrsõna	A2
usk	nimisõna	A2
uudis	nimisõna	A2
uuesti	määrsõna	A2
vabandus	nimisõna	A2
vaene	nimisõna	A2
vaene	omadussõna	A2
vaenlane	nimisõna	A2
vagun	nimisõna	A2
vahel	määrsõna	A2
vahel	kaassõna	A2
vahetama	tegusõna	A2
vahukoor	nimisõna	A2
vahvel	nimisõna	A2
vaid	määrsõna	A2
vaid	sidesõna	A2
vaikne	omadussõna	A2
vaikselt	määrsõna	A2
vaikus	nimisõna	A2
vaimne	omadussõna	A2
vajadus	nimisõna	A2
valama	tegusõna	A2
vald	nimisõna	A2
valesti	määrsõna	A2
valetama	tegusõna	A2
valik	nimisõna	A2
vallaline	omadussõna	A2
valmistama	tegusõna	A2
valu	nimisõna	A2
valus	omadussõna	A2
valuuta	nimisõna	A2
vanalinn	nimisõna	A2
vanem	nimisõna	A2
vangla	nimisõna	A2
vannituba	nimisõna	A2
vanus	nimisõna	A2
vara	määrsõna	A2
varem	määrsõna	A2
vari	nimisõna	A2
variant	nimisõna	A2
varvas	nimisõna	A2
vasakul	määrsõna	A2
vastu tulema	tegusõna	A2
vastu võtma	tegusõna	A2
vastuvõtt	nimisõna	A2
veekeetja	nimisõna	A2
veidi	määrsõna	A2
venekeelne	omadussõna	A2
vennanaine	nimisõna	A2
vennapoeg	nimisõna	A2
vennatütar	nimisõna	A2
veri	nimisõna	A2
verivorst	nimisõna	A2
video	nimisõna	A2
videokaamera	nimisõna	A2
viha	nimisõna	A2
vihane	omadussõna	A2
vihmavari	nimisõna	A2
viiekümnes	järgarvsõna	A2
viieteistkümnes	järgarvsõna	A2
viin	nimisõna	A2
viinamari	nimisõna	A2
viiner	nimisõna	A2
viisa	nimisõna	A2
viisakas	omadussõna	A2
vorm	nimisõna	A2
vorst	nimisõna	A2
vuntsid	nimisõna	A2
või	määrsõna	A2
võimalus	nimisõna	A2
võime	nimisõna	A2
võistlus	nimisõna	A2
võit	nimisõna	A2
võitma	tegusõna	A2
võrdlema	tegusõna	A2
võõrkeel	nimisõna	A2
võõrkeelne	omadussõna	A2
vähemalt	määrsõna	A2
välismaa	nimisõna	A2
välismaalane	nimisõna	A2
välja lülitama	tegusõna	A2
välja mõtlema	tegusõna	A2
välja nägema	tegusõna	A2
välja valima	tegusõna	A2
välja viskama	tegusõna	A2
väljak	nimisõna	A2
väljapääs	nimisõna	A2
väljuma	tegusõna	A2
värav	nimisõna	A2
värske	omadussõna	A2
värvima	tegusõna	A2
WC-paber	nimisõna	A2
õemees	nimisõna	A2
õepoeg	nimisõna	A2
õetütar	nimisõna	A2
õigus	nimisõna	A2
õlg	nimisõna	A2
õli	nimisõna	A2
õmbleja	nimisõna	A2
õnn	nimisõna	A2
õnnelik	omadussõna	A2
õnnetu	omadussõna	A2
õnnetus	nimisõna	A2
õppekeel	nimisõna	A2
õppetükk	nimisõna	A2
õunamahl	nimisõna	A2
õunapuu	nimisõna	A2
äkki	määrsõna	A2
ära minema	tegusõna	A2
äri	nimisõna	A2
ärimees	nimisõna	A2
ärkama	tegusõna	A2
ööpäev	nimisõna	A2
öösel	määrsõna	A2
öösärk	nimisõna	A2
üheksakümnes	järgarvsõna	A2
üheksateistkümnes	järgarvsõna	A2
ühendus	nimisõna	A2
ühesugune	omadussõna	A2
üheteistkümnes	järgarvsõna	A2
ühiselamu	nimisõna	A2
ühiskond	nimisõna	A2
ükskõik	määrsõna	A2
üksteise	asesõna	A2
üleeile	määrsõna	A2
ülemine	omadussõna	A2
üles kirjutama	tegusõna	A2
üles leidma	tegusõna	A2
üles otsima	tegusõna	A2
ülesanne	nimisõna	A2
ülikond	nimisõna	A2
üliõpilane	nimisõna	A2
üllatama	tegusõna	A2
ümber	määrsõna	A2
ümber	kaassõna	A2
üür	nimisõna	A2
