aadress	nimisõna	A1
aasta	nimisõna	A1
abi	nimisõna	A1
abikaasa	nimisõna	A1
aed	nimisõna	A1
aeg	nimisõna	A1
aeglane	omadussõna	A1
aga	sidesõna	A1
ainult	määrsõna	A1
aitama	tegusõna	A1
aitäh	hüüdsõna	A1
aken	nimisõna	A1
alati	määrsõna	A1
algama	tegusõna	A1
algus	nimisõna	A1
all	määrsõna	A1
all	kaassõna	A1
alla	määrsõna	A1
alla	kaassõna	A1
alt	kaassõna	A1
alustama	tegusõna	A1
andma	tegusõna	A1
apelsin	nimisõna	A1
appi	hüüdsõna	A1
aprill	nimisõna	A1
arbuus	nimisõna	A1
armastama	tegusõna	A1
armastus	nimisõna	A1
arst	nimisõna	A1
aru saama	tegusõna	A1
arv	nimisõna	A1
arvama	tegusõna	A1
arvuti	nimisõna	A1
asi	nimisõna	A1
asuma	tegusõna	A1
august	nimisõna	A1
auto	nimisõna	A1
banaan	nimisõna	A1
bensiin	nimisõna	A1
borš	nimisõna	A1
buss	nimisõna	A1
detsember	nimisõna	A1
diivan	nimisõna	A1
direktor	nimisõna	A1
dollar	nimisõna	A1
dušš	nimisõna	A1
edasi	määrsõna	A1
eelmine	omadussõna	A1
ees	määrsõna	A1
ees	kaassõna	A1
eesnimi	nimisõna	A1
eest	määrsõna	A1
eest	kaassõna	A1
eesti	käändumatu omadussõna	A1
eestlane	nimisõna	A1
ehitama	tegusõna	A1
ei	määrsõna	A1
eile	määrsõna	A1
elama	tegusõna	A1
elu	nimisõna	A1
ema	nimisõna	A1
emakeel	nimisõna	A1
enne	määrsõna	A1
enne	kaassõna	A1
erinev	omadussõna	A1
esimene	järgarvsõna	A1
esmaspäev	nimisõna	A1
et	sidesõna	A1
ette	määrsõna	A1
ette	kaassõna	A1
euro	nimisõna	A1
film	nimisõna	A1
firma	nimisõna	A1
foto	nimisõna	A1
grammatika	nimisõna	A1
grupp	nimisõna	A1
haige	omadussõna	A1
hakkama	tegusõna	A1
halb	omadussõna	A1
hall	omadussõna	A1
halloo	hüüdsõna	A1
hambaarst	nimisõna	A1
hammas	nimisõna	A1
hapukoor	nimisõna	A1
harva	määrsõna	A1
hea	omadussõna	A1
hele	omadussõna	A1
helistama	tegusõna	A1
hetk	nimisõna	A1
hilja	määrsõna	A1
hind	nimisõna	A1
homme	määrsõna	A1
hommik	nimisõna	A1
huvi	nimisõna	A1
huvitav	omadussõna	A1
härra	nimisõna	A1
hästi	määrsõna	A1
hääl	nimisõna	A1
ID-kaart	nimisõna	A1
idee	nimisõna	A1
iga	asesõna	A1
ikka	määrsõna	A1
ilm	nimisõna	A1
ilma	määrsõna	A1
ilma	kaassõna	A1
ilus	omadussõna	A1
info	nimisõna	A1
informatsioon	nimisõna	A1
inglise	käändumatu omadussõna	A1
inimene	nimisõna	A1
internet	nimisõna	A1
isa	nimisõna	A1
ise	asesõna	A1
istuma	tegusõna	A1
ja	sidesõna	A1
jaa	määrsõna	A1
jaanuar	nimisõna	A1
jah	määrsõna	A1
jalg	nimisõna	A1
jalgpall	nimisõna	A1
jalgratas	nimisõna	A1
jaoks	kaassõna	A1
jogurt	nimisõna	A1
jooksma	tegusõna	A1
jooksul	kaassõna	A1
jooma	tegusõna	A1
ju	määrsõna	A1
juba	määrsõna	A1
just	määrsõna	A1
jutt	nimisõna	A1
juuksed	nimisõna	A1
juuksur	nimisõna	A1
juuli	nimisõna	A1
juuni	nimisõna	A1
juurde	määrsõna	A1
juurde	kaassõna	A1
juures	kaassõna	A1
juurest	kaassõna	A1
juust	nimisõna	A1
jõgi	nimisõna	A1
jälle	määrsõna	A1
järele	määrsõna	A1
järgi	kaassõna	A1
järgmine	omadussõna	A1
järv	nimisõna	A1
jää	nimisõna	A1
jäätis	nimisõna	A1
ka	määrsõna	A1
kaart	nimisõna	A1
kaasa	määrsõna	A1
kaheksa	põhiarvsõna	A1
kaheksakümmend	põhiarvsõna	A1
kaheksas	järgarvsõna	A1
kaheksasada	põhiarvsõna	A1
kaheksateist	põhiarvsõna	A1
kahvel	nimisõna	A1
kakao	nimisõna	A1
kaks	põhiarvsõna	A1
kakskümmend	põhiarvsõna	A1
kakssada	põhiarvsõna	A1
kaksteist	põhiarvsõna	A1
kala	nimisõna	A1
kallis	omadussõna	A1
kana	nimisõna	A1
kapp	nimisõna	A1
kapsas	nimisõna	A1
kartul	nimisõna	A1
kas	määrsõna	A1
kass	nimisõna	A1
kasutama	tegusõna	A1
kasvama	tegusõna	A1
kaua	määrsõna	A1
kaudu	kaassõna	A1
kauplus	nimisõna	A1
keefir	nimisõna	A1
keel	nimisõna	A1
kell	nimisõna	A1
kerge	omadussõna	A1
kes	asesõna	A1
keskel	määrsõna	A1
keskel	kaassõna	A1
keskmine	omadussõna	A1
ketšup	nimisõna	A1
kevad	nimisõna	A1
kiiresti	määrsõna	A1
kilo	nimisõna	A1
kindel	omadussõna	A1
kindlasti	määrsõna	A1
kinni	määrsõna	A1
kino	nimisõna	A1
kiri	nimisõna	A1
kirjutama	tegusõna	A1
kitsas	omadussõna	A1
kivi	nimisõna	A1
klaas	nimisõna	A1
klass	nimisõna	A1
klient	nimisõna	A1
kodu	nimisõna	A1
koer	nimisõna	A1
kogu	asesõna	A1
kohal	määrsõna	A1
kohal	kaassõna	A1
kohale	määrsõna	A1
kohale	kaassõna	A1
kohe	määrsõna	A1
koht	nimisõna	A1
kohtuma	tegusõna	A1
kohtumiseni	hüüdsõna	A1
kohupiim	nimisõna	A1
kohv	nimisõna	A1
kohvik	nimisõna	A1
kokku	määrsõna	A1
kollane	omadussõna	A1
kolm	põhiarvsõna	A1
kolmapäev	nimisõna	A1
kolmas	järgarvsõna	A1
kolmkümmend	põhiarvsõna	A1
kolmsada	põhiarvsõna	A1
kolmteist	põhiarvsõna	A1
kontsert	nimisõna	A1
kook	nimisõna	A1
kool	nimisõna	A1
koor	nimisõna	A1
koos	määrsõna	A1
koos	kaassõna	A1
kord	nimisõna	A1
koridor	nimisõna	A1
koristama	tegusõna	A1
korrus	nimisõna	A1
korter	nimisõna	A1
korvpall	nimisõna	A1
kotlet	nimisõna	A1
kott	nimisõna	A1
kuhu	määrsõna	A1
kui	määrsõna	A1
kui	sidesõna	A1
kuid	sidesõna	A1
kuidas	määrsõna	A1
kukk	nimisõna	A1
kultuur	nimisõna	A1
kuni	kaassõna	A1
kuni	sidesõna	A1
kurk	nimisõna	A1
kus	määrsõna	A1
kust	määrsõna	A1
kuu	nimisõna	A1
kuues	järgarvsõna	A1
kuulama	tegusõna	A1
kuulma	tegusõna	A1
kuus	põhiarvsõna	A1
kuuskümmend	põhiarvsõna	A1
kuussada	põhiarvsõna	A1
kuusteist	põhiarvsõna	A1
kõht	nimisõna	A1
kõige	määrsõna	A1
kõik	asesõna	A1
kõrv	nimisõna	A1
kõrval	määrsõna	A1
kõrval	kaassõna	A1
kõrvale	määrsõna	A1
kõrvale	kaassõna	A1
käima	tegusõna	A1
käsi	nimisõna	A1
käsk	nimisõna	A1
köök	nimisõna	A1
küll	määrsõna	A1
külm	omadussõna	A1
kümme	põhiarvsõna	A1
kümnes	järgarvsõna	A1
küsima	tegusõna	A1
küsimus	nimisõna	A1
laev	nimisõna	A1
lagi	nimisõna	A1
lahti	määrsõna	A1
lai	omadussõna	A1
lamp	nimisõna	A1
laps	nimisõna	A1
lapselaps	nimisõna	A1
laud	nimisõna	A1
laul	nimisõna	A1
laulma	tegusõna	A1
laupäev	nimisõna	A1
leht	nimisõna	A1
leib	nimisõna	A1
leidma	tegusõna	A1
lemmik	omadussõna	A1
lendama	tegusõna	A1
lennuk	nimisõna	A1
liha	nimisõna	A1
lihtne	omadussõna	A1
lihtsalt	määrsõna	A1
liiga	määrsõna	A1
liikuma	tegusõna	A1
liiter	nimisõna	A1
lill	nimisõna	A1
lind	nimisõna	A1
linn	nimisõna	A1
loodus	nimisõna	A1
loom	nimisõna	A1
lubama	tegusõna	A1
lugema	tegusõna	A1
lugu	nimisõna	A1
lukk	nimisõna	A1
lumi	nimisõna	A1
lusikas	nimisõna	A1
lõpetama	tegusõna	A1
lõpp	nimisõna	A1
lõppema	tegusõna	A1
lõuna	nimisõna	A1
läbi	määrsõna	A1
läbi	kaassõna	A1
lühike	omadussõna	A1
ma	asesõna	A1
maa	nimisõna	A1
maailm	nimisõna	A1
maasikas	nimisõna	A1
magama	tegusõna	A1
mahl	nimisõna	A1
mai	nimisõna	A1
maja	nimisõna	A1
maksma	tegusõna	A1
mandariin	nimisõna	A1
masin	nimisõna	A1
me	asesõna	A1
meeldima	tegusõna	A1
meeldiv	omadussõna	A1
mees	nimisõna	A1
meeter	nimisõna	A1
meie	asesõna	A1
meri	nimisõna	A1
mets	nimisõna	A1
miinus	nimisõna	A1
miks	määrsõna	A1
miljard	põhiarvsõna	A1
miljon	põhiarvsõna	A1
millal	määrsõna	A1
milline	asesõna	A1
mina	asesõna	A1
minema	tegusõna	A1
minut	nimisõna	A1
mis	asesõna	A1
missugune	asesõna	A1
mitte	määrsõna	A1
mitu	asesõna	A1
mobiiltelefon	nimisõna	A1
morss	nimisõna	A1
mugav	omadussõna	A1
muidugi	määrsõna	A1
muna	nimisõna	A1
must	omadussõna	A1
muusika	nimisõna	A1
mõlemad	asesõna	A1
mõte	nimisõna	A1
mõtlema	tegusõna	A1
mägi	nimisõna	A1
mängima	tegusõna	A1
märts	nimisõna	A1
mööbel	nimisõna	A1
müüja	nimisõna	A1
müüma	tegusõna	A1
nad	asesõna	A1
naer	nimisõna	A1
naerma	tegusõna	A1
nagu	sidesõna	A1
naine	nimisõna	A1
nali	nimisõna	A1
natuke	määrsõna	A1
neli	põhiarvsõna	A1
nelikümmend	põhiarvsõna	A1
nelisada	põhiarvsõna	A1
neliteist	põhiarvsõna	A1
neljapäev	nimisõna	A1
neljas	järgarvsõna	A1
nemad	asesõna	A1
nii	määrsõna	A1
nimi	nimisõna	A1
nina	nimisõna	A1
ning	sidesõna	A1
noor	omadussõna	A1
november	nimisõna	A1
nuga	nimisõna	A1
null	põhiarvsõna	A1
number	nimisõna	A1
nurk	nimisõna	A1
nutma	tegusõna	A1
nõrk	omadussõna	A1
nõu	nimisõna	A1
nõudma	tegusõna	A1
nädal	nimisõna	A1
nädalavahetus	nimisõna	A1
nägema	tegusõna	A1
nägemiseni	hüüdsõna	A1
nägemist	hüüdsõna	A1
nägu	nimisõna	A1
näitama	tegusõna	A1
nüüd	määrsõna	A1
odav	omadussõna	A1
okei	hüüdsõna	A1
oktoober	nimisõna	A1
olema	tegusõna	A1
oluline	omadussõna	A1
oma	omadussõna	A1
oma	asesõna	A1
onu	nimisõna	A1
ootama	tegusõna	A1
osa	nimisõna	A1
oskama	tegusõna	A1
ostma	tegusõna	A1
otsima	tegusõna	A1
paar	nimisõna	A1
paar	asesõna	A1
paber	nimisõna	A1
padi	nimisõna	A1
paistma	tegusõna	A1
pakkuma	tegusõna	A1
paks	omadussõna	A1
palju	asesõna	A1
palju	määrsõna	A1
pall	nimisõna	A1
paluma	tegusõna	A1
panema	tegusõna	A1
parem	omadussõna	A1
park	nimisõna	A1
pass	nimisõna	A1
pastakas	nimisõna	A1
pastapliiats	nimisõna	A1
pea	nimisõna	A1
peal	määrsõna	A1
peal	kaassõna	A1
peale	määrsõna	A1
peale	kaassõna	A1
pealinn	nimisõna	A1
peatus	nimisõna	A1
pere	nimisõna	A1
perekond	nimisõna	A1
perekonnanimi	nimisõna	A1
pesema	tegusõna	A1
pidama	tegusõna	A1
pidu	nimisõna	A1
piim	nimisõna	A1
pikk	omadussõna	A1
pilet	nimisõna	A1
pilt	nimisõna	A1
PIN-kood	nimisõna	A1
pirn	nimisõna	A1
pirukas	nimisõna	A1
plaan	nimisõna	A1
pliiats	nimisõna	A1
pluss	nimisõna	A1
poeg	nimisõna	A1
poiss	nimisõna	A1
politsei	nimisõna	A1
pood	nimisõna	A1
pool	nimisõna	A1
pool	põhiarvsõna	A1
porgand	nimisõna	A1
praegu	määrsõna	A1
proua	nimisõna	A1
pruun	omadussõna	A1
pudel	nimisõna	A1
puhas	omadussõna	A1
puhkama	tegusõna	A1
puhkus	nimisõna	A1
puhul	kaassõna	A1
puiestee	nimisõna	A1
punane	omadussõna	A1
puu	nimisõna	A1
puuduma	tegusõna	A1
põrand	nimisõna	A1
päev	nimisõna	A1
päike	nimisõna	A1
pärast	kaassõna	A1
pärit olema	tegusõna	A1
pühapäev	nimisõna	A1
raadio	nimisõna	A1
raamat	nimisõna	A1
raha	nimisõna	A1
rahvas	nimisõna	A1
raske	omadussõna	A1
ratas	nimisõna	A1
reede	nimisõna	A1
reklaam	nimisõna	A1
restoran	nimisõna	A1
riis	nimisõna	A1
roheline	omadussõna	A1
rohkem	määrsõna	A1
rong	nimisõna	A1
rumal	omadussõna	A1
ruum	nimisõna	A1
rääkima	tegusõna	A1
sa	asesõna	A1
saama	tegusõna	A1
sada	põhiarvsõna	A1
sadama	tegusõna	A1
sai	nimisõna	A1
saksa	käändumatu omadussõna	A1
salat	nimisõna	A1
sama	asesõna	A1
seal	määrsõna	A1
sealt	määrsõna	A1
see	asesõna	A1
seen	nimisõna	A1
sees	määrsõna	A1
sees	kaassõna	A1
sein	nimisõna	A1
seisma	tegusõna	A1
seitse	põhiarvsõna	A1
seitsekümmend	põhiarvsõna	A1
seitsesada	põhiarvsõna	A1
seitseteist	põhiarvsõna	A1
seitsmes	järgarvsõna	A1
selg	nimisõna	A1
selge	omadussõna	A1
seljanka	nimisõna	A1
sellepärast	määrsõna	A1
selline	asesõna	A1
sent	nimisõna	A1
seoses	kaassõna	A1
september	nimisõna	A1
sest	sidesõna	A1
sibul	nimisõna	A1
sidrun	nimisõna	A1
siia	määrsõna	A1
siin	määrsõna	A1
siis	määrsõna	A1
siit	määrsõna	A1
sild	nimisõna	A1
silm	nimisõna	A1
sina	asesõna	A1
sinine	omadussõna	A1
sinna	määrsõna	A1
sisse	määrsõna	A1
sisse	kaassõna	A1
SMS	nimisõna	A1
sobima	tegusõna	A1
soe	omadussõna	A1
sool	nimisõna	A1
soome	käändumatu omadussõna	A1
soov	nimisõna	A1
soovima	tegusõna	A1
sportlane	nimisõna	A1
stopp	hüüdsõna	A1
sugulane	nimisõna	A1
suhkur	nimisõna	A1
supp	nimisõna	A1
surema	tegusõna	A1
surm	nimisõna	A1
suu	nimisõna	A1
suur	omadussõna	A1
suvi	nimisõna	A1
sõber	nimisõna	A1
sõitma	tegusõna	A1
sõna	nimisõna	A1
söök	nimisõna	A1
sööma	tegusõna	A1
sügis	nimisõna	A1
sündima	tegusõna	A1
sünnipäev	nimisõna	A1
šokolaad	nimisõna	A1
ta	asesõna	A1
taevas	nimisõna	A1
taga	määrsõna	A1
taga	kaassõna	A1
tagasi	määrsõna	A1
tagasi	kaassõna	A1
tahtma	tegusõna	A1
taim	nimisõna	A1
takso	nimisõna	A1
taldrik	nimisõna	A1
talv	nimisõna	A1
tants	nimisõna	A1
tark	omadussõna	A1
tass	nimisõna	A1
tatar	nimisõna	A1
tavaline	omadussõna	A1
te	asesõna	A1
teadma	tegusõna	A1
teater	nimisõna	A1
tee	nimisõna	A1
tee	nimisõna	A1
teel	kaassõna	A1
tegema	tegusõna	A1
teie	asesõna	A1
teine	järgarvsõna	A1
teisipäev	nimisõna	A1
tekk	nimisõna	A1
tekkima	tegusõna	A1
tekst	nimisõna	A1
telefon	nimisõna	A1
televiisor	nimisõna	A1
tema	asesõna	A1
temperatuur	nimisõna	A1
tere	hüüdsõna	A1
terve	omadussõna	A1
terve	asesõna	A1
tervis	nimisõna	A1
tervist	hüüdsõna	A1
test	nimisõna	A1
tihti	määrsõna	A1
tohtima	tegusõna	A1
toimuma	tegusõna	A1
toit	nimisõna	A1
tomat	nimisõna	A1
tool	nimisõna	A1
tooma	tegusõna	A1
tore	omadussõna	A1
tort	nimisõna	A1
tramm	nimisõna	A1
troll	nimisõna	A1
tualett	nimisõna	A1
tualettpaber	nimisõna	A1
tuba	nimisõna	A1
tubli	omadussõna	A1
tugev	omadussõna	A1
tuhat	põhiarvsõna	A1
tulema	tegusõna	A1
tuli	nimisõna	A1
tume	omadussõna	A1
tund	nimisõna	A1
tundma	tegusõna	A1
turg	nimisõna	A1
tuul	nimisõna	A1
tõusma	tegusõna	A1
tädi	nimisõna	A1
tähendama	tegusõna	A1
täht	nimisõna	A1
täna	määrsõna	A1
tänav	nimisõna	A1
töö	nimisõna	A1
töötama	tegusõna	A1
tüdruk	nimisõna	A1
tükk	nimisõna	A1
tütar	nimisõna	A1
ujuma	tegusõna	A1
uks	nimisõna	A1
uni	nimisõna	A1
unustama	tegusõna	A1
uskuma	tegusõna	A1
uus	omadussõna	A1
vaatama	tegusõna	A1
vaba	omadussõna	A1
vabandama	tegusõna	A1
vabandust	hüüdsõna	A1
vabariik	nimisõna	A1
vaevalt	määrsõna	A1
vaja	määrsõna	A1
vajalik	omadussõna	A1
vale	nimisõna	A1
vale	omadussõna	A1
valge	omadussõna	A1
valima	tegusõna	A1
valmis	omadussõna	A1
valmis	määrsõna	A1
valutama	tegusõna	A1
vana	omadussõna	A1
vanaema	nimisõna	A1
vanaisa	nimisõna	A1
vanemad	nimisõna	A1
vann	nimisõna	A1
varsti	määrsõna	A1
vastama	tegusõna	A1
vastu	määrsõna	A1
vastu	kaassõna	A1
vastus	nimisõna	A1
veebruar	nimisõna	A1
veel	määrsõna	A1
vein	nimisõna	A1
vend	nimisõna	A1
vene	käändumatu omadussõna	A1
venelane	nimisõna	A1
vesi	nimisõna	A1
viga	nimisõna	A1
vihik	nimisõna	A1
vihm	nimisõna	A1
viies	järgarvsõna	A1
viima	tegusõna	A1
viimane	omadussõna	A1
viis	põhiarvsõna	A1
viiskümmend	põhiarvsõna	A1
viissada	põhiarvsõna	A1
viisteist	põhiarvsõna	A1
viskama	tegusõna	A1
vist	määrsõna	A1
voodi	nimisõna	A1
või	nimisõna	A1
või	sidesõna	A1
võib-olla	määrsõna	A1
võileib	nimisõna	A1
võima	tegusõna	A1
võimalik	omadussõna	A1
võtma	tegusõna	A1
võõras	nimisõna	A1
võõras	omadussõna	A1
väga	määrsõna	A1
vähe	määrsõna	A1
vähem	määrsõna	A1
väike	omadussõna	A1
välja	määrsõna	A1
väljas	määrsõna	A1
värv	nimisõna	A1
WC	nimisõna	A1
õde	nimisõna	A1
õhk	nimisõna	A1
õhtu	nimisõna	A1
õige	omadussõna	A1
õlu	nimisõna	A1
õnnitlema	tegusõna	A1
õpetaja	nimisõna	A1
õpetama	tegusõna	A1
õpik	nimisõna	A1
õpilane	nimisõna	A1
õppima	tegusõna	A1
õu	nimisõna	A1
õun	nimisõna	A1
ära	määrsõna	A1
öö	nimisõna	A1
üheksa	põhiarvsõna	A1
üheksakümmend	põhiarvsõna	A1
üheksas	järgarvsõna	A1
üheksasada	põhiarvsõna	A1
üheksateist	põhiarvsõna	A1
üks	asesõna	A1
üks	põhiarvsõna	A1
ükssada	põhiarvsõna	A1
üksteist	põhiarvsõna	A1
üldse	määrsõna	A1
üle	määrsõna	A1
üle	kaassõna	A1
üles	määrsõna	A1
ütlema	tegusõna	A1
