aade	nimisõna	C1
aduma	tegusõna	C1
aegsasti	määrsõna	C1
aegu	kaassõna	C1
aegumatu	omadussõna	C1
agar	omadussõna	C1
agaralt	määrsõna	C1
ahastama	tegusõna	C1
ahastus	nimisõna	C1
ahistus	nimisõna	C1
ahmima	tegusõna	C1
aimama	tegusõna	C1
aines	nimisõna	C1
ainuõigus	nimisõna	C1
ajapikku	määrsõna	C1
ajatu	omadussõna	C1
ajel	kaassõna	C1
ajend	nimisõna	C1
ajendama	tegusõna	C1
ajuvaba	omadussõna	C1
akrediteerima	tegusõna	C1
alandlik	omadussõna	C1
alandlikkus	nimisõna	C1
alandus	nimisõna	C1
alatasa	määrsõna	C1
aldis	omadussõna	C1
althõlma	määrsõna	C1
and	nimisõna	C1
anduma	tegusõna	C1
anuma	tegusõna	C1
aps	nimisõna	C1
apsakas	nimisõna	C1
argus	nimisõna	C1
armetu	omadussõna	C1
arutu	omadussõna	C1
arveldus	nimisõna	C1
ase	nimisõna	C1
asetsema	tegusõna	C1
asjaosaline	omadussõna	C1
asjatu	omadussõna	C1
askeldama	tegusõna	C1
debüüt	nimisõna	C1
defineerima	tegusõna	C1
drastiline	omadussõna	C1
eales	määrsõna	C1
ebaedu	nimisõna	C1
ebakõla	nimisõna	C1
edev	omadussõna	C1
edevus	nimisõna	C1
edvistama	tegusõna	C1
eeldatavasti	määrsõna	C1
eestkoste	nimisõna	C1
eestkostja	nimisõna	C1
eestvõttel	määrsõna	C1
eirama	tegusõna	C1
eksiil	nimisõna	C1
eksistents	nimisõna	C1
eksistentsiaalne	omadussõna	C1
elatama	tegusõna	C1
elevil	omadussõna	C1
elevile	määrsõna	C1
elevus	nimisõna	C1
elukas	nimisõna	C1
empiiriline	omadussõna	C1
endastmõistetav	omadussõna	C1
enesekehtestamine	nimisõna	C1
eneseküllane	omadussõna	C1
enesestmõistetav	omadussõna	C1
eneseteadlik	omadussõna	C1
eneseteostus	nimisõna	C1
ennekuulmatu	omadussõna	C1
ennemuistne	omadussõna	C1
enneolematu	omadussõna	C1
eraklik	omadussõna	C1
ergas	omadussõna	C1
ergonoomiline	omadussõna	C1
esmajoones	määrsõna	C1
eufooria	nimisõna	C1
fundamentaalne	omadussõna	C1
generatsioon	nimisõna	C1
haaval	kaassõna	C1
habras	omadussõna	C1
hagema	tegusõna	C1
haihtuma	tegusõna	C1
hajameelne	omadussõna	C1
hajuma	tegusõna	C1
hajutama	tegusõna	C1
hakul	kaassõna	C1
hala	nimisõna	C1
halama	tegusõna	C1
hall	nimisõna	C1
harras	omadussõna	C1
harutama	tegusõna	C1
hauduma	tegusõna	C1
hautama	tegusõna	C1
heidutama	tegusõna	C1
heitlema	tegusõna	C1
heitlus	nimisõna	C1
helde	omadussõna	C1
hellus	nimisõna	C1
hingeldama	tegusõna	C1
hirmuäratav	omadussõna	C1
hoolas	omadussõna	C1
hoolekanne	nimisõna	C1
hoomama	tegusõna	C1
hord	nimisõna	C1
hulganisti	määrsõna	C1
hulluma	tegusõna	C1
hõikama	tegusõna	C1
hõiskama	tegusõna	C1
hõng	nimisõna	C1
hädasti	määrsõna	C1
hädavares	nimisõna	C1
hälve	nimisõna	C1
hämming	nimisõna	C1
häälestama	tegusõna	C1
hülgama	tegusõna	C1
idanema	tegusõna	C1
idu	nimisõna	C1
iha	nimisõna	C1
ihaldama	tegusõna	C1
ihkama	tegusõna	C1
ihu	nimisõna	C1
iive	nimisõna	C1
ike	nimisõna	C1
ilge	omadussõna	C1
ilmsiks	määrsõna	C1
ilmutus	nimisõna	C1
inimväärikus	nimisõna	C1
innukalt	määrsõna	C1
innukas	omadussõna	C1
irduma	tegusõna	C1
irvitama	tegusõna	C1
iseäralik	omadussõna	C1
iseäranis	määrsõna	C1
isikupärane	omadussõna	C1
itsitama	tegusõna	C1
jahuma	tegusõna	C1
johtuma	tegusõna	C1
jonnakas	omadussõna	C1
joonde	määrsõna	C1
juhtumisi	määrsõna	C1
jultunud	omadussõna	C1
jutlus	nimisõna	C1
juurdekasv	nimisõna	C1
juurdlema	tegusõna	C1
juurduma	tegusõna	C1
juurutama	tegusõna	C1
jõhkard	nimisõna	C1
jõllitama	tegusõna	C1
jõudsalt	määrsõna	C1
jõudsasti	määrsõna	C1
jõustama	tegusõna	C1
jäle	omadussõna	C1
jälile	määrsõna	C1
jäljendama	tegusõna	C1
jälk	omadussõna	C1
jännis	määrsõna	C1
järeleandlik	omadussõna	C1
jäse	nimisõna	C1
jässakas	omadussõna	C1
jäädav	omadussõna	C1
jäädavalt	määrsõna	C1
jäärapäine	omadussõna	C1
kaigas	nimisõna	C1
kalk	omadussõna	C1
kallutama	tegusõna	C1
kamandama	tegusõna	C1
kannapööre	nimisõna	C1
kannul	kaassõna	C1
kantima	tegusõna	C1
kants	nimisõna	C1
kaplan	nimisõna	C1
kargama	tegusõna	C1
karge	omadussõna	C1
karismaatiline	omadussõna	C1
kark	nimisõna	C1
karmistama	tegusõna	C1
karuteene	nimisõna	C1
kasin	omadussõna	C1
keevaline	omadussõna	C1
kehitama	tegusõna	C1
kelmikas	omadussõna	C1
kelmus	nimisõna	C1
kentsakas	omadussõna	C1
kerima	tegusõna	C1
kesine	omadussõna	C1
kibelema	tegusõna	C1
kiiduväärne	omadussõna	C1
kiikama	tegusõna	C1
kiiks	nimisõna	C1
kiindumus	nimisõna	C1
kimbutama	tegusõna	C1
kirgas	omadussõna	C1
kiruma	tegusõna	C1
kitkuma	tegusõna	C1
kitsikus	nimisõna	C1
kiudaine	nimisõna	C1
kiuslik	omadussõna	C1
kiuste	kaassõna	C1
klaar	omadussõna	C1
klaarima	tegusõna	C1
klammerduma	tegusõna	C1
klausel	nimisõna	C1
kobe	omadussõna	C1
koefitsient	nimisõna	C1
kognitiivne	omadussõna	C1
kohatu	omadussõna	C1
kohev	omadussõna	C1
kohkuma	tegusõna	C1
kohmetu	omadussõna	C1
kolama	tegusõna	C1
kompima	tegusõna	C1
kompleksne	omadussõna	C1
komplitseerima	tegusõna	C1
koomal	määrsõna	C1
koomale	määrsõna	C1
koon	nimisõna	C1
#koostööaldis	omadussõna	C1
kopsakas	omadussõna	C1
korvama	tegusõna	C1
kostitama	tegusõna	C1
kosuma	tegusõna	C1
kosutavalt	omadussõna	C1
kripeldama	tegusõna	C1
krutski	nimisõna	C1
kubisema	tegusõna	C1
kuhjama	tegusõna	C1
kuis	määrsõna	C1
kujutelm	nimisõna	C1
kuma	nimisõna	C1
kumama	tegusõna	C1
kummutama	tegusõna	C1
kunde	nimisõna	C1
kurikael	nimisõna	C1
kurioosne	omadussõna	C1
kurioosum	nimisõna	C1
kurnama	tegusõna	C1
kurnatud	omadussõna	C1
kurnatus	nimisõna	C1
kutsumus	nimisõna	C1
kuuldavasti	määrsõna	C1
kõhe	omadussõna	C1
kõigiti	määrsõna	C1
kõlapind	nimisõna	C1
kõlbeline	omadussõna	C1
kõle	omadussõna	C1
kõmu	nimisõna	C1
kõõluma	tegusõna	C1
käendaja	nimisõna	C1
käeulatuses	määrsõna	C1
käeulatusse	määrsõna	C1
käibele	määrsõna	C1
kära	nimisõna	C1
käratama	tegusõna	C1
käre	omadussõna	C1
kärme	omadussõna	C1
kärmesti	määrsõna	C1
kärsitu	omadussõna	C1
kätkema	tegusõna	C1
köitev	omadussõna	C1
küllaga	määrsõna	C1
küllaldane	omadussõna	C1
küllastama	tegusõna	C1
küllastuma	tegusõna	C1
küllus	nimisõna	C1
külmavärin	nimisõna	C1
kündma	tegusõna	C1
künnis	nimisõna	C1
küttima	tegusõna	C1
küündima	tegusõna	C1
küüniline	omadussõna	C1
küüsi	kaassõna	C1
küüsis	kaassõna	C1
küüsist	kaassõna	C1
laabuma	tegusõna	C1
laastama	tegusõna	C1
lagedale	määrsõna	C1
lagendik	nimisõna	C1
lahkarvamus	nimisõna	C1
lahkheli	nimisõna	C1
lahmima	tegusõna	C1
lahvatama	tegusõna	C1
laiaulatuslik	omadussõna	C1
laitma	tegusõna	C1
laitmatu	omadussõna	C1
laiuma	tegusõna	C1
laiutama	tegusõna	C1
lajatama	tegusõna	C1
lakkamatu	omadussõna	C1
lakkima	tegusõna	C1
lakkuma	tegusõna	C1
laotama	tegusõna	C1
lappama	tegusõna	C1
lappima	tegusõna	C1
lasuma	tegusõna	C1
latv	nimisõna	C1
lebama	tegusõna	C1
lehvima	tegusõna	C1
lepitus	nimisõna	C1
lesima	tegusõna	C1
lihtsakoeline	omadussõna	C1
liigutav	omadussõna	C1
lindprii	omadussõna	C1
lippama	tegusõna	C1
lipsama	tegusõna	C1
loid	omadussõna	C1
lookas	määrsõna	C1
lopsakas	omadussõna	C1
luhtuma	tegusõna	C1
luiskama	tegusõna	C1
lummama	tegusõna	C1
lummav	omadussõna	C1
lust	nimisõna	C1
lustakas	omadussõna	C1
lustlik	omadussõna	C1
lõpmatu	omadussõna	C1
läkitama	tegusõna	C1
lämmatama	tegusõna	C1
lävima	tegusõna	C1
lüpsma	tegusõna	C1
maandama	tegusõna	C1
maiasmokk	nimisõna	C1
maitsekalt	määrsõna	C1
manama	tegusõna	C1
manguma	tegusõna	C1
manitsema	tegusõna	C1
mantlipärija	nimisõna	C1
marginaal	nimisõna	C1
marginaalne	omadussõna	C1
maru	nimisõna	C1
maru	omadussõna	C1
materdama	tegusõna	C1
matkima	tegusõna	C1
matsutama	tegusõna	C1
meeleheitlik	omadussõna	C1
meelekindlus	nimisõna	C1
meelestama	tegusõna	C1
meelevaldne	omadussõna	C1
melu	nimisõna	C1
menetlema	tegusõna	C1
minetama	tegusõna	C1
mitmepalgeline	omadussõna	C1
mitmetahuline	omadussõna	C1
mitmevõistlus	nimisõna	C1
moonduma	tegusõna	C1
moonutama	tegusõna	C1
morn	omadussõna	C1
mugandama	tegusõna	C1
muhe	omadussõna	C1
muhelema	tegusõna	C1
muie	nimisõna	C1
murdu	määrsõna	C1
muundama	tegusõna	C1
mõjur	nimisõna	C1
mõlgutama	tegusõna	C1
mõõn	nimisõna	C1
märter	nimisõna	C1
mässima	tegusõna	C1
määratu	omadussõna	C1
möllama	tegusõna	C1
mürama	tegusõna	C1
naeruvääristama	tegusõna	C1
napakas	omadussõna	C1
napsama	tegusõna	C1
narr	omadussõna	C1
narritama	tegusõna	C1
nentima	tegusõna	C1
nigel	omadussõna	C1
nihkuma	tegusõna	C1
nikerdama	tegusõna	C1
niru	omadussõna	C1
nobe	omadussõna	C1
nohik	omadussõna	C1
nomenklatuur	nimisõna	C1
noomima	tegusõna	C1
noteerima	tegusõna	C1
nuhkima	tegusõna	C1
nuhtlema	tegusõna	C1
nuhtlus	nimisõna	C1
nupukas	omadussõna	C1
nuputama	tegusõna	C1
nurin	nimisõna	C1
nurisema	tegusõna	C1
nurjama	tegusõna	C1
nurjuma	tegusõna	C1
nõiaring	nimisõna	C1
nõlv	nimisõna	C1
nõmedus	nimisõna	C1
nähtu	nimisõna	C1
nähtuma	tegusõna	C1
näksima	tegusõna	C1
näppama	tegusõna	C1
näägutama	tegusõna	C1
nääklema	tegusõna	C1
nääklus	nimisõna	C1
nördima	tegusõna	C1
nördimus	nimisõna	C1
nühkima	tegusõna	C1
nüüdisaegne	omadussõna	C1
ohjama	tegusõna	C1
ohter	omadussõna	C1
oivaline	omadussõna	C1
olevus	nimisõna	C1
omajagu	määrsõna	C1
omakasupüüdlik	omadussõna	C1
omakasupüüdmatu	omadussõna	C1
osadus	nimisõna	C1
osatama	tegusõna	C1
oskuslik	omadussõna	C1
otsekohe	määrsõna	C1
otsekohene	omadussõna	C1
paeluma	tegusõna	C1
pagema	tegusõna	C1
paharet	nimisõna	C1
pahe	nimisõna	C1
paikkond	nimisõna	C1
painama	tegusõna	C1
paine	nimisõna	C1
paiskama	tegusõna	C1
paiskuma	tegusõna	C1
paisuma	tegusõna	C1
paisutama	tegusõna	C1
paitama	tegusõna	C1
pajatama	tegusõna	C1
pakatama	tegusõna	C1
pakiline	omadussõna	C1
pale	nimisõna	C1
parajalt	määrsõna	C1
paslik	omadussõna	C1
passima	tegusõna	C1
patsutama	tegusõna	C1
peaasjalikult	määrsõna	C1
pealetükkiv	omadussõna	C1
peatne	omadussõna	C1
peenetundeline	omadussõna	C1
peibutama	tegusõna	C1
pelk	omadussõna	C1
pihtima	tegusõna	C1
pihtimus	nimisõna	C1
piiga	nimisõna	C1
piiluma	tegusõna	C1
pikisilmi	määrsõna	C1
pilduma	tegusõna	C1
pilkama	tegusõna	C1
pillama	tegusõna	C1
pimesi	määrsõna	C1
poetama	tegusõna	C1
pomisema	tegusõna	C1
ponnistama	tegusõna	C1
pookima	tegusõna	C1
populatsioon	nimisõna	C1
poputama	tegusõna	C1
ports	nimisõna	C1
praktiseerima	tegusõna	C1
prii	omadussõna	C1
primaarne	omadussõna	C1
priske	omadussõna	C1
proovikivi	nimisõna	C1
pudenema	tegusõna	C1
puistama	tegusõna	C1
pungil	määrsõna	C1
pungis	omadussõna	C1
punnima	tegusõna	C1
punnitama	tegusõna	C1
purema	tegusõna	C1
purjuspäi	määrsõna	C1
pussitama	tegusõna	C1
põgusalt	määrsõna	C1
põhjapanev	omadussõna	C1
põikama	tegusõna	C1
põikpäine	omadussõna	C1
põikpäisus	nimisõna	C1
põimima	tegusõna	C1
põlgama	tegusõna	C1
põline	omadussõna	C1
põrkama	tegusõna	C1
põrnitsema	tegusõna	C1
põruma	tegusõna	C1
päevakajaline	omadussõna	C1
pärgama	tegusõna	C1
päri	määrsõna	C1
pärisori	nimisõna	C1
pärssima	tegusõna	C1
päädima	tegusõna	C1
pügama	tegusõna	C1
pühadus	nimisõna	C1
pühalikkus	nimisõna	C1
pühamu	nimisõna	C1
püüdlema	tegusõna	C1
raatsima	tegusõna	C1
rabama	tegusõna	C1
rabav	omadussõna	C1
raie	nimisõna	C1
raiuma	tegusõna	C1
raju	nimisõna	C1
rammima	tegusõna	C1
rammus	omadussõna	C1
rassima	tegusõna	C1
ratifitseerima	tegusõna	C1
raugema	tegusõna	C1
reibas	omadussõna	C1
riiakas	omadussõna	C1
riivama	tegusõna	C1
riknema	tegusõna	C1
risustama	tegusõna	C1
robustne	omadussõna	C1
rusu	nimisõna	C1
rusuma	tegusõna	C1
rõve	omadussõna	C1
räige	omadussõna	C1
räsima	tegusõna	C1
räämas	omadussõna	C1
röstima	tegusõna	C1
röökima	tegusõna	C1
rügama	tegusõna	C1
rühkima	tegusõna	C1
rüü	nimisõna	C1
rüüpama	tegusõna	C1
rüüstama	tegusõna	C1
saadus	nimisõna	C1
sade	nimisõna	C1
salgama	tegusõna	C1
sant	omadussõna	C1
seadistama	tegusõna	C1
sebima	tegusõna	C1
sedapuhku	määrsõna	C1
seik	nimisõna	C1
seilama	tegusõna	C1
seiskuma	tegusõna	C1
sekundaarne	omadussõna	C1
selgima	tegusõna	C1
sellal	määrsõna	C1
siginema	tegusõna	C1
sihik	nimisõna	C1
siirdama	tegusõna	C1
siirus	nimisõna	C1
sikutama	tegusõna	C1
sillutama	tegusõna	C1
silmama	tegusõna	C1
silmitsema	tegusõna	C1
sinisilmne	omadussõna	C1
sirguma	tegusõna	C1
sissekanne	nimisõna	C1
sitikas	nimisõna	C1
sitke	omadussõna	C1
sohk	nimisõna	C1
sokutama	tegusõna	C1
solidaarne	omadussõna	C1
solk	nimisõna	C1
solkima	tegusõna	C1
sombune	omadussõna	C1
soodumus	nimisõna	C1
soostuma	tegusõna	C1
sootuks	määrsõna	C1
suisa	määrsõna	C1
sume	omadussõna	C1
summutama	tegusõna	C1
suvatsema	tegusõna	C1
sätendama	tegusõna	C1
sätestama	tegusõna	C1
söandama	tegusõna	C1
sööstma	tegusõna	C1
süüvima	tegusõna	C1
taamal	määrsõna	C1
taevalik	omadussõna	C1
tagandama	tegusõna	C1
tagaselja	määrsõna	C1
taibukas	omadussõna	C1
taidlus	nimisõna	C1
taies	nimisõna	C1
taiplik	omadussõna	C1
takka	kaassõna	C1
talitama	tegusõna	C1
talitlus	nimisõna	C1
tallama	tegusõna	C1
talletama	tegusõna	C1
taltsutama	tegusõna	C1
talumatu	omadussõna	C1
talvituma	tegusõna	C1
tampima	tegusõna	C1
tarduma	tegusõna	C1
tarne	nimisõna	C1
tasavägine	omadussõna	C1
tavatu	omadussõna	C1
teisaldama	tegusõna	C1
teisejärguline	omadussõna	C1
tembeldama	tegusõna	C1
temp	nimisõna	C1
teoloogiline	omadussõna	C1
teotahteline	omadussõna	C1
terane	omadussõna	C1
teritama	tegusõna	C1
tihke	omadussõna	C1
tikkuma	tegusõna	C1
tiksuma	tegusõna	C1
timmima	tegusõna	C1
toibuma	tegusõna	C1
toimekas	omadussõna	C1
torisema	tegusõna	C1
totter	omadussõna	C1
trall	nimisõna	C1
trampima	tegusõna	C1
trots	nimisõna	C1
trotsima	tegusõna	C1
trügima	tegusõna	C1
tuhin	nimisõna	C1
tukkuma	tegusõna	C1
tuletorn	nimisõna	C1
tulus	omadussõna	C1
tulvil	määrsõna	C1
turri	määrsõna	C1
turvama	tegusõna	C1
tuttu	määrsõna	C1
tuuker	nimisõna	C1
tuulama	tegusõna	C1
tuumik	nimisõna	C1
tõene	omadussõna	C1
tõhusalt	määrsõna	C1
tõik	nimisõna	C1
tõmblema	tegusõna	C1
tõrges	määrsõna	C1
tõrkuma	tegusõna	C1
tõttama	tegusõna	C1
tõuge	nimisõna	C1
tõuklema	tegusõna	C1
täbar	omadussõna	C1
täidesaatev	omadussõna	C1
tänini	määrsõna	C1
tüdimus	nimisõna	C1
tükkima	tegusõna	C1
tüürima	tegusõna	C1
tüütama	tegusõna	C1
uhiuus	omadussõna	C1
uhkeldama	tegusõna	C1
uhtuma	tegusõna	C1
uimastama	tegusõna	C1
uitama	tegusõna	C1
umbmäärane	omadussõna	C1
umbusk	nimisõna	C1
upitama	tegusõna	C1
upsakas	omadussõna	C1
utoopiline	omadussõna	C1
vaagima	tegusõna	C1
vaatevinkel	nimisõna	C1
vaateväli	nimisõna	C1
vaga	omadussõna	C1
vagur	omadussõna	C1
vaibuma	tegusõna	C1
vaigistama	tegusõna	C1
vaimukas	omadussõna	C1
vajaka	määrsõna	C1
valguma	tegusõna	C1
valla	määrsõna	C1
vallanduma	tegusõna	C1
vallatu	omadussõna	C1
valvas	omadussõna	C1
vangutama	tegusõna	C1
varal	kaassõna	C1
vastakas	omadussõna	C1
vastupandamatu	omadussõna	C1
veeretama	tegusõna	C1
veetlev	omadussõna	C1
vehkima	tegusõna	C1
vestma	tegusõna	C1
vigur	nimisõna	C1
viks	omadussõna	C1
vilgas	omadussõna	C1
viljelema	tegusõna	C1
vilkuma	tegusõna	C1
vingerdama	tegusõna	C1
vinguma	tegusõna	C1
virk	omadussõna	C1
virutama	tegusõna	C1
virvendama	tegusõna	C1
vits	nimisõna	C1
vohama	tegusõna	C1
voog	nimisõna	C1
vooruslik	omadussõna	C1
vurama	tegusõna	C1
võhik	nimisõna	C1
võhm	nimisõna	C1
võigas	omadussõna	C1
võpatama	tegusõna	C1
võra	nimisõna	C1
võrratu	omadussõna	C1
võrsuma	tegusõna	C1
võõranduma	tegusõna	C1
võõrutama	tegusõna	C1
väeti	omadussõna	C1
väidetavasti	määrsõna	C1
väikekodanlik	omadussõna	C1
väiklane	omadussõna	C1
väisama	tegusõna	C1
väitlema	tegusõna	C1
väitlus	nimisõna	C1
väle	omadussõna	C1
vältama	tegusõna	C1
vänge	omadussõna	C1
väntama	tegusõna	C1
värdjas	nimisõna	C1
värin	nimisõna	C1
vääramatu	omadussõna	C1
väärikus	nimisõna	C1
väärtegu	nimisõna	C1
vöönd	nimisõna	C1
õdus	omadussõna	C1
õelus	nimisõna	C1
õhin	nimisõna	C1
õhinal	määrsõna	C1
õhkama	tegusõna	C1
õhkuma	tegusõna	C1
õiendama	tegusõna	C1
õilis	omadussõna	C1
õnneseen	nimisõna	C1
õnnis	omadussõna	C1
õnnistama	tegusõna	C1
õnnistus	nimisõna	C1
õpetlane	nimisõna	C1
õukond	nimisõna	C1
õõnes	omadussõna	C1
õõnestama	tegusõna	C1
äkitselt	määrsõna	C1
ängistus	nimisõna	C1
äpardus	nimisõna	C1
ärakiri	nimisõna	C1
ärandama	tegusõna	C1
ärevil	määrsõna	C1
ärevile	määrsõna	C1
ärgitama	tegusõna	C1
ärkvel	määrsõna	C1
ärkvele	määrsõna	C1
ääristama	tegusõna	C1
üdi	nimisõna	C1
ühtaegu	määrsõna	C1
ühtekuuluvus	nimisõna	C1
ühtima	tegusõna	C1
ühtviisi	määrsõna	C1
ühtäkki	määrsõna	C1
üksildane	omadussõna	C1
üksjagu	määrsõna	C1
üksluine	omadussõna	C1
ülearune	omadussõna	C1
ülekohtune	omadussõna	C1
ülendama	tegusõna	C1
üleolek	nimisõna	C1
üleolev	omadussõna	C1
ülev	omadussõna	C1
üllas	omadussõna	C1
üllitama	tegusõna	C1
üllitis	nimisõna	C1
ürgne	omadussõna	C1
üüratu	omadussõna	C1
üürike	omadussõna	C1
