aabits	nimisõna	B1
aas	nimisõna	B1
aastaaeg	nimisõna	B1
aastavahetus	nimisõna	B1
abielupaar	nimisõna	B1
abinõu	nimisõna	B1
abistama	tegusõna	B1
abivalmis	omadussõna	B1
administraator	nimisõna	B1
advokaat	nimisõna	B1
aednik	nimisõna	B1
aedvili	nimisõna	B1
aeglaselt	määrsõna	B1
aeroobika	nimisõna	B1
aevastama	tegusõna	B1
agressiivne	omadussõna	B1
ahi	nimisõna	B1
ahjuküte	nimisõna	B1
ahv	nimisõna	B1
ahven	nimisõna	B1
ainsus	nimisõna	B1
ainuke	omadussõna	B1
ainukene	omadussõna	B1
ainus	omadussõna	B1
ajaloolane	nimisõna	B1
ajalooline	omadussõna	B1
ajavahemik	nimisõna	B1
aju	nimisõna	B1
ajutine	omadussõna	B1
ajutiselt	määrsõna	B1
aknalaud	nimisõna	B1
akordion	nimisõna	B1
aktiivselt	määrsõna	B1
aktiivsus	nimisõna	B1
aktsia	nimisõna	B1
aktsiaselts	nimisõna	B1
aktus	nimisõna	B1
aku	nimisõna	B1
akvaarium	nimisõna	B1
alaealine	nimisõna	B1
alaealine	omadussõna	B1
alaline	omadussõna	B1
alandama	tegusõna	B1
alarm	nimisõna	B1
alasti	omadussõna	B1
alasti	määrsõna	B1
algaja	nimisõna	B1
algatama	tegusõna	B1
algatus	nimisõna	B1
algklass	nimisõna	B1
algkool	nimisõna	B1
algselt	määrsõna	B1
algul	määrsõna	B1
algul	kaassõna	B1
alkohoolik	nimisõna	B1
alla andma	tegusõna	B1
alla hindama	tegusõna	B1
alla kirjutama	tegusõna	B1
alla laadima	tegusõna	B1
allahindlus	nimisõna	B1
allapoole	määrsõna	B1
allapoole	kaassõna	B1
allergia	nimisõna	B1
alles	määrsõna	B1
alles hoidma	tegusõna	B1
alles jätma	tegusõna	B1
alles jääma	tegusõna	B1
allikas	nimisõna	B1
allpool	määrsõna	B1
allpool	kaassõna	B1
alluma	tegusõna	B1
alluv	nimisõna	B1
allveelaev	nimisõna	B1
alternatiiv	nimisõna	B1
altpoolt	määrsõna	B1
altpoolt	kaassõna	B1
aluspesu	nimisõna	B1
alussärk	nimisõna	B1
alustass	nimisõna	B1
ametikoht	nimisõna	B1
ametlik	omadussõna	B1
ametlikult	määrsõna	B1
ametnik	nimisõna	B1
analüüsima	tegusõna	B1
andekas	omadussõna	B1
andeks andma	tegusõna	B1
andeks paluma	tegusõna	B1
andestama	tegusõna	B1
anekdoot	nimisõna	B1
angerjas	nimisõna	B1
angiin	nimisõna	B1
ankeet	nimisõna	B1
annus	nimisõna	B1
antenn	nimisõna	B1
antibiootikum	nimisõna	B1
aprikoos	nimisõna	B1
apteek	nimisõna	B1
apteeker	nimisõna	B1
araabia	käändumatu omadussõna	B1
arendama	tegusõna	B1
arenema	tegusõna	B1
arg	omadussõna	B1
argpüks	nimisõna	B1
arhiiv	nimisõna	B1
arm	nimisõna	B1
armee	nimisõna	B1
armuke	nimisõna	B1
armuma	tegusõna	B1
artist	nimisõna	B1
aru andma	tegusõna	B1
aruanne	nimisõna	B1
arukas	omadussõna	B1
arusaadav	omadussõna	B1
arusaam	nimisõna	B1
arusaamatu	omadussõna	B1
arutamine	nimisõna	B1
arutelu	nimisõna	B1
arutlema	tegusõna	B1
arutlus	nimisõna	B1
arvatavasti	määrsõna	B1
arvesse võtma	tegusõna	B1
arvestama	tegusõna	B1
arvestus	nimisõna	B1
arvutama	tegusõna	B1
arvutioskus	nimisõna	B1
asemel	kaassõna	B1
asemele	määrsõna	B1
asemele	kaassõna	B1
asendama	tegusõna	B1
aset leidma	tegusõna	B1
asetama	tegusõna	B1
asfalt	nimisõna	B1
asjalik	omadussõna	B1
asjaolu	nimisõna	B1
asjatundja	nimisõna	B1
aste	nimisõna	B1
astuma	tegusõna	B1
asukoht	nimisõna	B1
asutama	tegusõna	B1
asutus	nimisõna	B1
au	nimisõna	B1
auhind	nimisõna	B1
aula	nimisõna	B1
austama	tegusõna	B1
austatud	omadussõna	B1
austus	nimisõna	B1
autokool	nimisõna	B1
automaat	nimisõna	B1
automaatne	omadussõna	B1
autopesula	nimisõna	B1
autoteenindus	nimisõna	B1
avaldama	tegusõna	B1
avalduma	tegusõna	B1
avalik	omadussõna	B1
avalikult	määrsõna	B1
avalikustama	tegusõna	B1
avamine	nimisõna	B1
avanema	tegusõna	B1
avar	omadussõna	B1
avastama	tegusõna	B1
avokaado	nimisõna	B1
baarmen	nimisõna	B1
bakter	nimisõna	B1
baleriin	nimisõna	B1
ballett	nimisõna	B1
beebi	nimisõna	B1
betoon	nimisõna	B1
bikiinid	nimisõna	B1
bioloogia	nimisõna	B1
blankett	nimisõna	B1
blender	nimisõna	B1
blond	omadussõna	B1
broiler	nimisõna	B1
brokoli	nimisõna	B1
broneerima	tegusõna	B1
brünett	omadussõna	B1
bussipeatus	nimisõna	B1
büroo	nimisõna	B1
delegatsioon	nimisõna	B1
demokraatia	nimisõna	B1
demokraatlik	omadussõna	B1
dialoog	nimisõna	B1
dieet	nimisõna	B1
digiallkiri	nimisõna	B1
digitaalne	omadussõna	B1
diislikütus	nimisõna	B1
diplom	nimisõna	B1
diplomaat	nimisõna	B1
diplomaatiline	omadussõna	B1
dirigent	nimisõna	B1
disain	nimisõna	B1
disainer	nimisõna	B1
diskussioon	nimisõna	B1
distants	nimisõna	B1
draama	nimisõna	B1
ebaaus	omadussõna	B1
ebaharilik	omadussõna	B1
ebakindel	omadussõna	B1
ebakindlus	nimisõna	B1
ebamugav	omadussõna	B1
ebaoluline	omadussõna	B1
ebapiisav	omadussõna	B1
ebaseaduslik	omadussõna	B1
ebaselge	omadussõna	B1
ebasobiv	omadussõna	B1
ebatavaline	omadussõna	B1
ebatervislik	omadussõna	B1
ebaviisakas	omadussõna	B1
ebaõiglane	omadussõna	B1
ebaõnnestuma	tegusõna	B1
edasi andma	tegusõna	B1
edasi jõudma	tegusõna	B1
edasi lükkama	tegusõna	B1
edasi-tagasi	määrsõna	B1
edaspidi	määrsõna	B1
edastama	tegusõna	B1
edel	nimisõna	B1
edukalt	määrsõna	B1
edukas	omadussõna	B1
eel	kaassõna	B1
eelarvamus	nimisõna	B1
eelarve	nimisõna	B1
eeldama	tegusõna	B1
eeldus	nimisõna	B1
eelis	nimisõna	B1
eelistama	tegusõna	B1
eelkõige	määrsõna	B1
eelnema	tegusõna	B1
eelroog	nimisõna	B1
eelviimane	omadussõna	B1
eemaldama	tegusõna	B1
eemale	määrsõna	B1
eesel	nimisõna	B1
eeskiri	nimisõna	B1
eeskuju	nimisõna	B1
eeskätt	määrsõna	B1
eesotsas	kaassõna	B1
eespool	määrsõna	B1
eestpoolt	määrsõna	B1
efekt	nimisõna	B1
efektiivne	omadussõna	B1
ehe	nimisõna	B1
ehitamine	nimisõna	B1
ehitis	nimisõna	B1
ehkki	sidesõna	B1
ehmatama	tegusõna	B1
eilne	omadussõna	B1
eitama	tegusõna	B1
eksima	tegusõna	B1
eksitus	nimisõna	B1
ekspert	nimisõna	B1
elamu	nimisõna	B1
elanikkond	nimisõna	B1
elektrik	nimisõna	B1
elektriküte	nimisõna	B1
elektripliit	nimisõna	B1
elektririke	nimisõna	B1
elektroonika	nimisõna	B1
elektrooniline	omadussõna	B1
element	nimisõna	B1
elevant	nimisõna	B1
ellu jääma	tegusõna	B1
ellu viima	tegusõna	B1
elukaaslane	nimisõna	B1
elukutse	nimisõna	B1
elulookirjeldus	nimisõna	B1
elulugu	nimisõna	B1
eluohtlik	omadussõna	B1
eluruum	nimisõna	B1
eluviis	nimisõna	B1
emadepäev	nimisõna	B1
emane	nimisõna	B1
emane	omadussõna	B1
emotsionaalne	omadussõna	B1
emotsioon	nimisõna	B1
enam-vähem	määrsõna	B1
enamasti	määrsõna	B1
enamik	nimisõna	B1
enamus	nimisõna	B1
endine	omadussõna	B1
endiselt	määrsõna	B1
energiline	omadussõna	B1
enesekindel	omadussõna	B1
enesekindlus	nimisõna	B1
enesetunne	nimisõna	B1
ennustama	tegusõna	B1
eraelu	nimisõna	B1
erakond	nimisõna	B1
erakool	nimisõna	B1
erakorraline	omadussõna	B1
eraldama	tegusõna	B1
eramaa	nimisõna	B1
eramaja	nimisõna	B1
erand	nimisõna	B1
erapooletu	omadussõna	B1
eratund	nimisõna	B1
erialane	omadussõna	B1
erinema	tegusõna	B1
erinevalt	määrsõna	B1
erinevus	nimisõna	B1
eripära	nimisõna	B1
eristama	tegusõna	B1
ese	nimisõna	B1
esialgne	omadussõna	B1
esialgu	määrsõna	B1
esikoht	nimisõna	B1
esile	määrsõna	B1
esile kutsuma	tegusõna	B1
esile tooma	tegusõna	B1
esile tõstma	tegusõna	B1
esimees	nimisõna	B1
esindaja	nimisõna	B1
esindama	tegusõna	B1
esindus	nimisõna	B1
esineja	nimisõna	B1
esinemine	nimisõna	B1
esitama	tegusõna	B1
esiteks	määrsõna	B1
esitlema	tegusõna	B1
esitus	nimisõna	B1
esmaabi	nimisõna	B1
esmakordselt	määrsõna	B1
esmalt	määrsõna	B1
esmane	omadussõna	B1
etendus	nimisõna	B1
ette heitma	tegusõna	B1
ette kandma	tegusõna	B1
ette kujutama	tegusõna	B1
ette lugema	tegusõna	B1
ette nägema	tegusõna	B1
ette teatama	tegusõna	B1
ette valmistama	tegusõna	B1
ette võtma	tegusõna	B1
ette ütlema	tegusõna	B1
ettekujutus	nimisõna	B1
ettepoole	määrsõna	B1
ettevaatlikult	määrsõna	B1
ettevaatus	nimisõna	B1
ettevalmistus	nimisõna	B1
ettevõtja	nimisõna	B1
ettevõtmine	nimisõna	B1
eurone	nimisõna	B1
eurooplane	nimisõna	B1
fail	nimisõna	B1
farm	nimisõna	B1
filmima	tegusõna	B1
finaal	nimisõna	B1
finiš	nimisõna	B1
flööt	nimisõna	B1
friikartulid	nimisõna	B1
frikadell	nimisõna	B1
funktsioon	nimisõna	B1
fänn	nimisõna	B1
füüsika	nimisõna	B1
füüsiline	omadussõna	B1
gaasiküte	nimisõna	B1
gaasipliit	nimisõna	B1
galerii	nimisõna	B1
garaaž	nimisõna	B1
garanteerima	tegusõna	B1
garantiiaeg	nimisõna	B1
geograafia	nimisõna	B1
giid	nimisõna	B1
graafik	nimisõna	B1
gramm	nimisõna	B1
granaatõun	nimisõna	B1
grill	nimisõna	B1
grillima	tegusõna	B1
grillkana	nimisõna	B1
gripp	nimisõna	B1
haaknõel	nimisõna	B1
haamer	nimisõna	B1
haav	nimisõna	B1
hai	nimisõna	B1
haigekassa	nimisõna	B1
haigusleht	nimisõna	B1
hais	nimisõna	B1
hakkama saama	tegusõna	B1
halb	nimisõna	B1
halvemini	määrsõna	B1
halvenema	tegusõna	B1
hammustama	tegusõna	B1
hamster	nimisõna	B1
hankima	tegusõna	B1
hapu	omadussõna	B1
hapukapsas	nimisõna	B1
harakas	nimisõna	B1
haridustee	nimisõna	B1
harilik	omadussõna	B1
harilikult	määrsõna	B1
harima	tegusõna	B1
harjuma	tegusõna	B1
harjumus	nimisõna	B1
harjutama	tegusõna	B1
harjutamine	nimisõna	B1
harrastama	tegusõna	B1
haruldane	omadussõna	B1
hauakivi	nimisõna	B1
haud	nimisõna	B1
haug	nimisõna	B1
haukuma	tegusõna	B1
hea	nimisõna	B1
heaks	kaassõna	B1
heaks kiitma	tegusõna	B1
heategevus	nimisõna	B1
heeringas	nimisõna	B1
hein	nimisõna	B1
heitma	tegusõna	B1
heli	nimisõna	B1
helikopter	nimisõna	B1
helilooja	nimisõna	B1
helisema	tegusõna	B1
helkur	nimisõna	B1
herilane	nimisõna	B1
hernes	nimisõna	B1
higi	nimisõna	B1
higistama	tegusõna	B1
hiina	käändumatu omadussõna	B1
hiinlane	nimisõna	B1
hiline	omadussõna	B1
hilinema	tegusõna	B1
hilisõhtu	nimisõna	B1
hiljuti	määrsõna	B1
hiljutine	omadussõna	B1
hingedepäev	nimisõna	B1
hinnang	nimisõna	B1
hinne	nimisõna	B1
hirm	nimisõna	B1
hirmus	omadussõna	B1
hirmutama	tegusõna	B1
hispaania	käändumatu omadussõna	B1
hispaanlane	nimisõna	B1
hoiak	nimisõna	B1
hoiatama	tegusõna	B1
hoiatus	nimisõna	B1
hoki	nimisõna	B1
hollandi	käändumatu omadussõna	B1
hollandlane	nimisõna	B1
hommikumantel	nimisõna	B1
homne	omadussõna	B1
honorar	nimisõna	B1
hool	nimisõna	B1
hooldaja	nimisõna	B1
hoolealune	nimisõna	B1
hoolima	tegusõna	B1
hoolimata	kaassõna	B1
hoopis	määrsõna	B1
hukka mõistma	tegusõna	B1
hukkuma	tegusõna	B1
hulgast	kaassõna	B1
hull	nimisõna	B1
hull	omadussõna	B1
huulepulk	nimisõna	B1
huumor	nimisõna	B1
huvikool	nimisõna	B1
hõbe	nimisõna	B1
hõbemedal	nimisõna	B1
häbelik	omadussõna	B1
häbenema	tegusõna	B1
häbi	nimisõna	B1
hädavajalik	omadussõna	B1
häire	nimisõna	B1
häirima	tegusõna	B1
hämar	omadussõna	B1
hävima	tegusõna	B1
hävitama	tegusõna	B1
hääldama	tegusõna	B1
hääletama	tegusõna	B1
hääletus	nimisõna	B1
häälik	nimisõna	B1
hüvasti	hüüdsõna	B1
hüüdma	tegusõna	B1
hüüumärk	nimisõna	B1
iga	nimisõna	B1
iga-aastane	omadussõna	B1
igasugune	omadussõna	B1
igati	määrsõna	B1
igatsema	tegusõna	B1
iialgi	määrsõna	B1
iiveldama	tegusõna	B1
ilma jääma	tegusõna	B1
ilmaennustus	nimisõna	B1
ilmakaar	nimisõna	B1
ilmateade	nimisõna	B1
ilmne	omadussõna	B1
ilmselt	määrsõna	B1
ilmuma	tegusõna	B1
ilmutama	tegusõna	B1
ilu	nimisõna	B1
ilusasti	määrsõna	B1
ilusti	määrsõna	B1
ilutulestik	nimisõna	B1
iluuisutaja	nimisõna	B1
ime	nimisõna	B1
imema	tegusõna	B1
imetlema	tegusõna	B1
individuaalne	omadussõna	B1
inetu	omadussõna	B1
informeerima	tegusõna	B1
infotehnoloogia	nimisõna	B1
inimlik	omadussõna	B1
instituut	nimisõna	B1
internetipank	nimisõna	B1
internetiühendus	nimisõna	B1
intress	nimisõna	B1
isadepäev	nimisõna	B1
isane	nimisõna	B1
iseenese	asesõna	B1
iseenesest	määrsõna	B1
isegi	määrsõna	B1
iseloomulik	omadussõna	B1
iseloomustama	tegusõna	B1
iseseisev	omadussõna	B1
iseseisvalt	määrsõna	B1
iseseisvus	nimisõna	B1
iseseisvuspäev	nimisõna	B1
isik	nimisõna	B1
isiklikult	määrsõna	B1
isiksus	nimisõna	B1
isikukood	nimisõna	B1
isikutunnistus	nimisõna	B1
iste	nimisõna	B1
istekoht	nimisõna	B1
isu	nimisõna	B1
itaalia	käändumatu omadussõna	B1
itaallane	nimisõna	B1
jaapani	käändumatu omadussõna	B1
jaapanlane	nimisõna	B1
jagamine	nimisõna	B1
jaguma	tegusõna	B1
jagunema	tegusõna	B1
jahimees	nimisõna	B1
jaht	nimisõna	B1
jakk	nimisõna	B1
jaksama	tegusõna	B1
jalakäija	nimisõna	B1
jalalaba	nimisõna	B1
jalats	nimisõna	B1
janu	nimisõna	B1
jaoskond	nimisõna	B1
jaotama	tegusõna	B1
joodik	nimisõna	B1
jooks	nimisõna	B1
jooneline	omadussõna	B1
joonistamine	nimisõna	B1
joonistus	nimisõna	B1
joonlaud	nimisõna	B1
jube	omadussõna	B1
juhe	nimisõna	B1
juhend	nimisõna	B1
juhendaja	nimisõna	B1
juhtiv	omadussõna	B1
juhtkond	nimisõna	B1
juhus	nimisõna	B1
juhuslik	omadussõna	B1
julgelt	määrsõna	B1
julgesti	määrsõna	B1
julgus	nimisõna	B1
jumalateenistus	nimisõna	B1
juriidiline	omadussõna	B1
justkui	määrsõna	B1
justkui	sidesõna	B1
jutukas	omadussõna	B1
jutumärgid	nimisõna	B1
juukselakk	nimisõna	B1
juurde võtma	tegusõna	B1
jõhvikas	nimisõna	B1
jõulupühad	nimisõna	B1
jõuluvana	nimisõna	B1
jõusaal	nimisõna	B1
jälg	nimisõna	B1
jälgima	tegusõna	B1
järeldus	nimisõna	B1
järele aitama	tegusõna	B1
järele jõudma	tegusõna	B1
järele jätma	tegusõna	B1
järele jääma	tegusõna	B1
järele mõtlema	tegusõna	B1
järelevalve	nimisõna	B1
järelikult	määrsõna	B1
järelmaks	nimisõna	B1
järgima	tegusõna	B1
järglane	nimisõna	B1
järgnema	tegusõna	B1
järjekordne	omadussõna	B1
järjest	määrsõna	B1
järsk	omadussõna	B1
järsku	määrsõna	B1
jätkuma	tegusõna	B1
jätkuvalt	määrsõna	B1
jääkaru	nimisõna	B1
jääpurikas	nimisõna	B1
Jäär	nimisõna	B1
kaabu	nimisõna	B1
kaalikas	nimisõna	B1
kaas	nimisõna	B1
kaasa aitama	tegusõna	B1
kaasa elama	tegusõna	B1
kaasa lööma	tegusõna	B1
kaasa rääkima	tegusõna	B1
kaasa tegema	tegusõna	B1
kaasa tooma	tegusõna	B1
kaasa tundma	tegusõna	B1
kaasa võtma	tegusõna	B1
kaasaegne	omadussõna	B1
kaasas kandma	tegusõna	B1
kaaskiri	nimisõna	B1
kaastunne	nimisõna	B1
kaater	nimisõna	B1
kabe	nimisõna	B1
kadripäev	nimisõna	B1
kaebama	tegusõna	B1
kaelakee	nimisõna	B1
kaer	nimisõna	B1
kaerahelbed	nimisõna	B1
kaev	nimisõna	B1
kaevama	tegusõna	B1
kagu	nimisõna	B1
kahekesi	määrsõna	B1
kahekordne	omadussõna	B1
kahekorruseline	omadussõna	B1
kaheksakorruseline	omadussõna	B1
kahetoaline	omadussõna	B1
kahetsema	tegusõna	B1
kahjulik	omadussõna	B1
kahjum	nimisõna	B1
kahjustama	tegusõna	B1
kahtlane	omadussõna	B1
kahtlema	tegusõna	B1
kahtlus	nimisõna	B1
kahtlustama	tegusõna	B1
kaine	omadussõna	B1
kaitsevägi	nimisõna	B1
kajakas	nimisõna	B1
kajut	nimisõna	B1
kaklema	tegusõna	B1
kaksik	nimisõna	B1
kakskeelne	omadussõna	B1
kaktus	nimisõna	B1
kalamees	nimisõna	B1
kalapulk	nimisõna	B1
kalapüük	nimisõna	B1
kali	nimisõna	B1
kaljukits	nimisõna	B1
kalkulaator	nimisõna	B1
kallale	määrsõna	B1
kallale	kaassõna	B1
kallale tungima	tegusõna	B1
kalliskivi	nimisõna	B1
kallistama	tegusõna	B1
kalur	nimisõna	B1
kama	nimisõna	B1
kamin	nimisõna	B1
kanal	nimisõna	B1
kanalisatsioon	nimisõna	B1
kand	nimisõna	B1
kandideerima	tegusõna	B1
kandik	nimisõna	B1
kandiline	omadussõna	B1
kange	omadussõna	B1
kangelane	nimisõna	B1
kann	nimisõna	B1
kannatama	tegusõna	B1
kannatanu	nimisõna	B1
kannatus	nimisõna	B1
kannel	nimisõna	B1
kantselei	nimisõna	B1
kaotaja	nimisõna	B1
kaotus	nimisõna	B1
kapten	nimisõna	B1
kapuuts	nimisõna	B1
karamell	nimisõna	B1
karate	nimisõna	B1
kardin	nimisõna	B1
kari	nimisõna	B1
karikakar	nimisõna	B1
karikas	nimisõna	B1
karistama	tegusõna	B1
karistus	nimisõna	B1
karjuma	tegusõna	B1
karjäär	nimisõna	B1
kartulipuder	nimisõna	B1
karusmari	nimisõna	B1
karv	nimisõna	B1
karvane	omadussõna	B1
kask	nimisõna	B1
kastan	nimisõna	B1
kastma	tegusõna	B1
kasukas	nimisõna	B1
kasutaja	nimisõna	B1
kasutajanimi	nimisõna	B1
kasutajatunnus	nimisõna	B1
kasutamisjuhend	nimisõna	B1
kasutus	nimisõna	B1
kasutusjuhend	nimisõna	B1
kasvatus	nimisõna	B1
kasvuhoone	nimisõna	B1
kate	nimisõna	B1
katkema	tegusõna	B1
katkestama	tegusõna	B1
katkine	omadussõna	B1
katma	tegusõna	B1
katoliiklik	omadussõna	B1
katoliku	käändumatu omadussõna	B1
katse	nimisõna	B1
katsetama	tegusõna	B1
katsetus	nimisõna	B1
katsuma	tegusõna	B1
kauaks	määrsõna	B1
kaugus	nimisõna	B1
kaunistama	tegusõna	B1
kauplema	tegusõna	B1
kaval	omadussõna	B1
kavandama	tegusõna	B1
kavatsema	tegusõna	B1
keelama	tegusõna	B1
keelatud	omadussõna	B1
keeld	nimisõna	B1
keelduma	tegusõna	B1
keeleoskus	nimisõna	B1
keelteoskus	nimisõna	B1
keema	tegusõna	B1
keemia	nimisõna	B1
keemiline	omadussõna	B1
keep	nimisõna	B1
keerlema	tegusõna	B1
kehaline	omadussõna	B1
kehtima	tegusõna	B1
kehtiv	omadussõna	B1
kehv	omadussõna	B1
kehvasti	määrsõna	B1
kellassepp	nimisõna	B1
kelluke	nimisõna	B1
kelner	nimisõna	B1
kenasti	määrsõna	B1
kepp	nimisõna	B1
kergejõustik	nimisõna	B1
kergelt	määrsõna	B1
kergesti	määrsõna	B1
keset	kaassõna	B1
keskealine	omadussõna	B1
keskele	määrsõna	B1
keskelt	kaassõna	B1
keskenduma	tegusõna	B1
keskharidus	nimisõna	B1
keskkond	nimisõna	B1
keskkonnasõbralik	omadussõna	B1
keskkool	nimisõna	B1
keskküte	nimisõna	B1
keskpäev	nimisõna	B1
kesköö	nimisõna	B1
kets	nimisõna	B1
kett	nimisõna	B1
kevadine	omadussõna	B1
kevadpüha	nimisõna	B1
kibe	omadussõna	B1
kihla vedama	tegusõna	B1
kihlatud	määrsõna	B1
kiik	nimisõna	B1
kiikuma	tegusõna	B1
kiirendama	tegusõna	B1
kiirtee	nimisõna	B1
kiirus	nimisõna	B1
kiirustama	tegusõna	B1
kiitus	nimisõna	B1
kiiver	nimisõna	B1
kiivi	nimisõna	B1
kile	nimisõna	B1
kilogramm	nimisõna	B1
kilone	omadussõna	B1
kilpkonn	nimisõna	B1
kilu	nimisõna	B1
kimp	nimisõna	B1
kindlalt	määrsõna	B1
kindlus	nimisõna	B1
kindlustama	tegusõna	B1
kindlustus	nimisõna	B1
kindral	nimisõna	B1
kingsepp	nimisõna	B1
kink	nimisõna	B1
kinni keerama	tegusõna	B1
kinni panema	tegusõna	B1
kinni püüdma	tegusõna	B1
kinnine	omadussõna	B1
kinnisvara	nimisõna	B1
kinnitama	tegusõna	B1
kinnitus	nimisõna	B1
kiosk	nimisõna	B1
kirg	nimisõna	B1
kirja panema	tegusõna	B1
kirjalik	omadussõna	B1
kirjalikult	määrsõna	B1
kirjastus	nimisõna	B1
kirjavahemärk	nimisõna	B1
kirjavahetus	nimisõna	B1
kirjutis	nimisõna	B1
kirre	nimisõna	B1
kirst	nimisõna	B1
kirurg	nimisõna	B1
kirves	nimisõna	B1
kisa	nimisõna	B1
kitarr	nimisõna	B1
kits	nimisõna	B1
kiusama	tegusõna	B1
klahv	nimisõna	B1
klassijuhataja	nimisõna	B1
klassika	nimisõna	B1
klassivend	nimisõna	B1
klassiõde	nimisõna	B1
klaver	nimisõna	B1
kleepima	tegusõna	B1
kleeplint	nimisõna	B1
klienditeenindaja	nimisõna	B1
kliima	nimisõna	B1
kliinik	nimisõna	B1
kloun	nimisõna	B1
kodanik	nimisõna	B1
kodujuust	nimisõna	B1
koduleht	nimisõna	B1
kodulind	nimisõna	B1
kodulinn	nimisõna	B1
koduloom	nimisõna	B1
kodumaine	omadussõna	B1
kodumasin	nimisõna	B1
kodunt	määrsõna	B1
kodutu	nimisõna	B1
kodutu	omadussõna	B1
kogema	tegusõna	B1
kogemata	määrsõna	B1
kogemus	nimisõna	B1
kogenud	omadussõna	B1
kogunema	tegusõna	B1
kogus	nimisõna	B1
koha	nimisõna	B1
kohalik	nimisõna	B1
kohalik	omadussõna	B1
kohalt	kaassõna	B1
kohanema	tegusõna	B1
kohapeal	määrsõna	B1
kohaselt	kaassõna	B1
kohati	määrsõna	B1
kohtama	tegusõna	B1
kohtunik	nimisõna	B1
kohus	nimisõna	B1
kohustus	nimisõna	B1
kohustuslik	omadussõna	B1
kohutav	omadussõna	B1
kohver	nimisõna	B1
kohvipaus	nimisõna	B1
kokku hoidma	tegusõna	B1
kokku langema	tegusõna	B1
kokku leppima	tegusõna	B1
kokku puutuma	tegusõna	B1
kokku saama	tegusõna	B1
kokku sobima	tegusõna	B1
kokku tulema	tegusõna	B1
kokku viima	tegusõna	B1
kokku võtma	tegusõna	B1
kokkulepe	nimisõna	B1
kokkutulek	nimisõna	B1
kokkuvõte	nimisõna	B1
kole	omadussõna	B1
kolju	nimisõna	B1
kolledž	nimisõna	B1
kollektsioon	nimisõna	B1
kolmandaks	määrsõna	B1
kolmandik	nimisõna	B1
kolmandik	põhiarvsõna	B1
kolmekesi	määrsõna	B1
kolmekordne	omadussõna	B1
kolmekorruseline	omadussõna	B1
kolmetoaline	omadussõna	B1
kolmnurk	nimisõna	B1
kolmnurkne	omadussõna	B1
kolmveerand	põhiarvsõna	B1
koma	nimisõna	B1
komitee	nimisõna	B1
komme	nimisõna	B1
kommenteerima	tegusõna	B1
kompanii	nimisõna	B1
komplekt	nimisõna	B1
kompromiss	nimisõna	B1
komöödia	nimisõna	B1
kondiiter	nimisõna	B1
kondoom	nimisõna	B1
kongress	nimisõna	B1
konjak	nimisõna	B1
konks	nimisõna	B1
konserv	nimisõna	B1
konsultant	nimisõna	B1
konsultatsioon	nimisõna	B1
kontaktandmed	nimisõna	B1
kontekst	nimisõna	B1
konto	nimisõna	B1
kontojääk	nimisõna	B1
kontonumber	nimisõna	B1
konts	nimisõna	B1
kood	nimisõna	B1
kookos	nimisõna	B1
koolitarbed	nimisõna	B1
koolitus	nimisõna	B1
koolivaheaeg	nimisõna	B1
koolivend	nimisõna	B1
kooliõde	nimisõna	B1
koolon	nimisõna	B1
koondama	tegusõna	B1
koondis	nimisõna	B1
koormus	nimisõna	B1
koosnema	tegusõna	B1
koosolek	nimisõna	B1
koosseis	nimisõna	B1
koostama	tegusõna	B1
koostis	nimisõna	B1
kops	nimisõna	B1
kopsupõletik	nimisõna	B1
koputama	tegusõna	B1
kord	määrsõna	B1
korda tegema	tegusõna	B1
korduma	tegusõna	B1
korduvalt	määrsõna	B1
koristaja	nimisõna	B1
kork	nimisõna	B1
korpus	nimisõna	B1
korraga	määrsõna	B1
korraks	määrsõna	B1
korral	kaassõna	B1
korraldaja	nimisõna	B1
korraldama	tegusõna	B1
korralikult	määrsõna	B1
korrektne	omadussõna	B1
korruptsioon	nimisõna	B1
korrutama	tegusõna	B1
korsten	nimisõna	B1
kortermaja	nimisõna	B1
korts	nimisõna	B1
kosmeetik	nimisõna	B1
kosmos	nimisõna	B1
kostüüm	nimisõna	B1
kotkas	nimisõna	B1
kraadiklaas	nimisõna	B1
kraadima	tegusõna	B1
kraanikauss	nimisõna	B1
kreeka	käändumatu omadussõna	B1
kreeklane	nimisõna	B1
kreem	nimisõna	B1
krevett	nimisõna	B1
kriis	nimisõna	B1
kriitik	nimisõna	B1
kriitika	nimisõna	B1
kriitiline	omadussõna	B1
kringel	nimisõna	B1
kristlane	nimisõna	B1
kristlik	omadussõna	B1
kritiseerima	tegusõna	B1
krokodill	nimisõna	B1
kroon	nimisõna	B1
krooniline	omadussõna	B1
krunt	nimisõna	B1
kruvi	nimisõna	B1
kruvikeeraja	nimisõna	B1
krõpsud	nimisõna	B1
kuduma	tegusõna	B1
kudumine	nimisõna	B1
kuigi	sidesõna	B1
kuivama	tegusõna	B1
kuivatama	tegusõna	B1
kuju	nimisõna	B1
kujundama	tegusõna	B1
kujunema	tegusõna	B1
kujutama	tegusõna	B1
kukal	nimisõna	B1
kukeseen	nimisõna	B1
kuld	nimisõna	B1
kuldmedal	nimisõna	B1
kulg	nimisõna	B1
kullassepp	nimisõna	B1
kuller	nimisõna	B1
kulm	nimisõna	B1
kulp	nimisõna	B1
kulu	nimisõna	B1
kulul	kaassõna	B1
kuluma	tegusõna	B1
kulutama	tegusõna	B1
kumb	asesõna	B1
kumbki	asesõna	B1
kumm	nimisõna	B1
kummaline	omadussõna	B1
kummel	nimisõna	B1
kuna	sidesõna	B1
kunagine	omadussõna	B1
kuninganna	nimisõna	B1
kunstlik	omadussõna	B1
kurat	nimisõna	B1
kurbus	nimisõna	B1
kurg	nimisõna	B1
kuri	nimisõna	B1
kuritegevus	nimisõna	B1
kuritegu	nimisõna	B1
kurjategija	nimisõna	B1
kursis olema	tegusõna	B1
kurssi viima	tegusõna	B1
kurt	nimisõna	B1
kurt	omadussõna	B1
kurtma	tegusõna	B1
kurv	nimisõna	B1
kurvalt	määrsõna	B1
kusagil	määrsõna	B1
kusagile	määrsõna	B1
kusagilt	määrsõna	B1
kuskil	määrsõna	B1
kuskile	määrsõna	B1
kustukumm	nimisõna	B1
kustutama	tegusõna	B1
kustutuskumm	nimisõna	B1
kutse	nimisõna	B1
kutseharidus	nimisõna	B1
kutsekool	nimisõna	B1
kutsikas	nimisõna	B1
kuuekorruseline	omadussõna	B1
kuuendik	põhiarvsõna	B1
kuul	nimisõna	B1
kuulaja	nimisõna	B1
kuulsus	nimisõna	B1
kuupäev	nimisõna	B1
kvaliteet	nimisõna	B1
kvaliteetne	omadussõna	B1
kvartal	nimisõna	B1
kviitung	nimisõna	B1
kõhuli	määrsõna	B1
kõikjal	määrsõna	B1
kõikvõimalik	omadussõna	B1
kõlama	tegusõna	B1
kõlar	nimisõna	B1
kõlbama	tegusõna	B1
kõnnitee	nimisõna	B1
kõrb	nimisõna	B1
kõrgel	määrsõna	B1
kõrgele	määrsõna	B1
kõrgelt	määrsõna	B1
kõrgharidus	nimisõna	B1
kõrghoone	nimisõna	B1
kõrgkool	nimisõna	B1
kõrgune	omadussõna	B1
kõrvaklapid	nimisõna	B1
kõrvale jätma	tegusõna	B1
kõrvale jääma	tegusõna	B1
kõrvalt	määrsõna	B1
kõrvalt	kaassõna	B1
kõrvits	nimisõna	B1
kõrvuti	määrsõna	B1
kõva	omadussõna	B1
kõvasti	määrsõna	B1
kõver	omadussõna	B1
käbi	nimisõna	B1
käekiri	nimisõna	B1
käekott	nimisõna	B1
käelaba	nimisõna	B1
käepide	nimisõna	B1
käes	kaassõna	B1
käesolev	omadussõna	B1
käest	kaassõna	B1
käibemaks	nimisõna	B1
käik	nimisõna	B1
käitumine	nimisõna	B1
kämping	nimisõna	B1
käpp	nimisõna	B1
kärbes	nimisõna	B1
käsitsi	määrsõna	B1
käsitöö	nimisõna	B1
käskima	tegusõna	B1
kätte	kaassõna	B1
kätte maksma	tegusõna	B1
kätte saama	tegusõna	B1
kättesaadav	omadussõna	B1
köha	nimisõna	B1
kübar	nimisõna	B1
kühvel	nimisõna	B1
külas	määrsõna	B1
külaskäik	nimisõna	B1
külg	nimisõna	B1
külge	määrsõna	B1
külge	kaassõna	B1
küljes	määrsõna	B1
küljes	kaassõna	B1
küljest	kaassõna	B1
külla	määrsõna	B1
küllalt	määrsõna	B1
küllaltki	määrsõna	B1
külmetama	tegusõna	B1
külmutatud	omadussõna	B1
kümmekond	nimisõna	B1
kümnendik	põhiarvsõna	B1
küpsema	tegusõna	B1
küpsetama	tegusõna	B1
küsimärk	nimisõna	B1
küsitlus	nimisõna	B1
küülik	nimisõna	B1
küünal	nimisõna	B1
küünarnukk	nimisõna	B1
küünlajalg	nimisõna	B1
küüs	nimisõna	B1
laad	nimisõna	B1
laadija	nimisõna	B1
laadima	tegusõna	B1
laager	nimisõna	B1
labidas	nimisõna	B1
ladu	nimisõna	B1
laenama	tegusõna	B1
laenutama	tegusõna	B1
laenutus	nimisõna	B1
lagunema	tegusõna	B1
lahe	omadussõna	B1
lahendama	tegusõna	B1
lahing	nimisõna	B1
lahja	omadussõna	B1
lahke	omadussõna	B1
lahku	määrsõna	B1
lahku minema	tegusõna	B1
lahkuma	tegusõna	B1
lahti keerama	tegusõna	B1
lahti tegema	tegusõna	B1
lahtine	omadussõna	B1
lahus	määrsõna	B1
laiali	määrsõna	B1
laialt	määrsõna	B1
laiendama	tegusõna	B1
laim	nimisõna	B1
laine	nimisõna	B1
laip	nimisõna	B1
laisk	omadussõna	B1
laiune	omadussõna	B1
laius	nimisõna	B1
lakk	nimisõna	B1
lamama	tegusõna	B1
langetama	tegusõna	B1
lapsehoidja	nimisõna	B1
lapsepõlv	nimisõna	B1
las	tegusõna	B1
laskma	tegusõna	B1
latikas	nimisõna	B1
laulmine	nimisõna	B1
laulupidu	nimisõna	B1
laup	nimisõna	B1
lausa	määrsõna	B1
laut	nimisõna	B1
lavastama	tegusõna	B1
lavastus	nimisõna	B1
leedulane	nimisõna	B1
leiduma	tegusõna	B1
lein	nimisõna	B1
leiutama	tegusõna	B1
lektor	nimisõna	B1
lend	nimisõna	B1
lepatriinu	nimisõna	B1
lesk	nimisõna	B1
lest	nimisõna	B1
lett	nimisõna	B1
levi	nimisõna	B1
levima	tegusõna	B1
levitama	tegusõna	B1
libe	omadussõna	B1
libisema	tegusõna	B1
liblikas	nimisõna	B1
ligi	määrsõna	B1
ligi	kaassõna	B1
ligikaudu	määrsõna	B1
lihapall	nimisõna	B1
lihas	nimisõna	B1
lihavõtted	nimisõna	B1
lihavõttepühad	nimisõna	B1
lihtsasti	määrsõna	B1
liider	nimisõna	B1
liiga tegema	tegusõna	B1
liigne	omadussõna	B1
liigutama	tegusõna	B1
liigutus	nimisõna	B1
liik	nimisõna	B1
liiklus	nimisõna	B1
liiklusmärk	nimisõna	B1
liiklusõnnetus	nimisõna	B1
liim	nimisõna	B1
liimima	tegusõna	B1
liitrine	nimisõna	B1
liitsõna	nimisõna	B1
liituma	tegusõna	B1
liiv	nimisõna	B1
lillkapsas	nimisõna	B1
limonaad	nimisõna	B1
lina	nimisõna	B1
link	nimisõna	B1
linnaosa	nimisõna	B1
linnapea	nimisõna	B1
linnavalitsus	nimisõna	B1
loe	nimisõna	B1
loend	nimisõna	B1
loeng	nimisõna	B1
lohutama	tegusõna	B1
lokkis	määrsõna	B1
loll	nimisõna	B1
loll	omadussõna	B1
loobuma	tegusõna	B1
loodetavasti	määrsõna	B1
looduslik	omadussõna	B1
loogiline	omadussõna	B1
loojuma	tegusõna	B1
loomaliha	nimisõna	B1
looming	nimisõna	B1
loominguline	omadussõna	B1
loomulik	omadussõna	B1
loomulikult	määrsõna	B1
loosung	nimisõna	B1
lootus	nimisõna	B1
lootusetu	omadussõna	B1
loterii	nimisõna	B1
lugemine	nimisõna	B1
lugu pidama	tegusõna	B1
luik	nimisõna	B1
lukksepp	nimisõna	B1
lukku keerama	tegusõna	B1
lukku panema	tegusõna	B1
lukus olema	tegusõna	B1
lumikelluke	nimisõna	B1
lumine	omadussõna	B1
luteri	käändumatu omadussõna	B1
luterlik	omadussõna	B1
luukere	nimisõna	B1
luuletaja	nimisõna	B1
luuletus	nimisõna	B1
lõbusalt	määrsõna	B1
lõhki	määrsõna	B1
lõhkuma	tegusõna	B1
lõhnama	tegusõna	B1
lõhnaõli	nimisõna	B1
lõikelaud	nimisõna	B1
lõikus	nimisõna	B1
lõpetaja	nimisõna	B1
lõpetamine	nimisõna	B1
lõplik	omadussõna	B1
lõplikult	määrsõna	B1
lõpule viima	tegusõna	B1
lõug	nimisõna	B1
lõunasöök	nimisõna	B1
lõvi	nimisõna	B1
läbi astuma	tegusõna	B1
läbi kukkuma	tegusõna	B1
läbi käima	tegusõna	B1
läbi laskma	tegusõna	B1
läbi mõtlema	tegusõna	B1
läbi saama	tegusõna	B1
läbi vaatama	tegusõna	B1
läbipaistev	omadussõna	B1
läbirääkimised	nimisõna	B1
lähedalt	määrsõna	B1
lähedalt	kaassõna	B1
lähedane	nimisõna	B1
lähemal	määrsõna	B1
lähemale	määrsõna	B1
lähenema	tegusõna	B1
läikima	tegusõna	B1
lörts	nimisõna	B1
löök	nimisõna	B1
lööve	nimisõna	B1
lühidalt	määrsõna	B1
lükkama	tegusõna	B1
lülitama	tegusõna	B1
lünk	nimisõna	B1
lütseum	nimisõna	B1
maadlus	nimisõna	B1
maailmameister	nimisõna	B1
maakaart	nimisõna	B1
maakler	nimisõna	B1
maalima	tegusõna	B1
maanduma	tegusõna	B1
maapind	nimisõna	B1
maas	määrsõna	B1
maavärin	nimisõna	B1
madalal	määrsõna	B1
madrats	nimisõna	B1
madrus	nimisõna	B1
madu	nimisõna	B1
magu	nimisõna	B1
maha jätma	tegusõna	B1
maha jääma	tegusõna	B1
maha kirjutama	tegusõna	B1
maha laskma	tegusõna	B1
maha minema	tegusõna	B1
maha murdma	tegusõna	B1
maha müüma	tegusõna	B1
maha põlema	tegusõna	B1
maha põletama	tegusõna	B1
maha tõmbama	tegusõna	B1
maha unustama	tegusõna	B1
maha vaikima	tegusõna	B1
maha võtma	tegusõna	B1
mahlane	omadussõna	B1
maht	nimisõna	B1
mahtuma	tegusõna	B1
maikelluke	nimisõna	B1
mainima	tegusõna	B1
mais	nimisõna	B1
maitse	nimisõna	B1
maitseaine	nimisõna	B1
maitsema	tegusõna	B1
maitsma	tegusõna	B1
majanduslik	omadussõna	B1
majanduslikult	määrsõna	B1
maks	nimisõna	B1
maksja	nimisõna	B1
maksmine	nimisõna	B1
male	nimisõna	B1
mander	nimisõna	B1
maniküür	nimisõna	B1
manna	nimisõna	B1
mantel	nimisõna	B1
mardipäev	nimisõna	B1
margariin	nimisõna	B1
marker	nimisõna	B1
marsruut	nimisõna	B1
mass	nimisõna	B1
massaaž	nimisõna	B1
massöör	nimisõna	B1
matemaatika	nimisõna	B1
materiaalne	omadussõna	B1
matk	nimisõna	B1
matkama	tegusõna	B1
matma	tegusõna	B1
matt	nimisõna	B1
matus	nimisõna	B1
medal	nimisõna	B1
meditsiin	nimisõna	B1
meel	nimisõna	B1
meelde jääma	tegusõna	B1
meelde tulema	tegusõna	B1
meeldivalt	määrsõna	B1
meelelahutus	nimisõna	B1
meeles olema	tegusõna	B1
meeles pidama	tegusõna	B1
meelest	kaassõna	B1
meelest minema	tegusõna	B1
meenutama	tegusõna	B1
meessugu	nimisõna	B1
meestearst	nimisõna	B1
meetod	nimisõna	B1
meetrine	omadussõna	B1
mehaanik	nimisõna	B1
mehhanism	nimisõna	B1
meik	nimisõna	B1
meiliaadress	nimisõna	B1
meilima	tegusõna	B1
melon	nimisõna	B1
meloodia	nimisõna	B1
menüü	nimisõna	B1
merisiga	nimisõna	B1
mesilane	nimisõna	B1
metroo	nimisõna	B1
metskits	nimisõna	B1
metsloom	nimisõna	B1
metsmaasikas	nimisõna	B1
metssiga	nimisõna	B1
mikrofon	nimisõna	B1
mikser	nimisõna	B1
millegipärast	määrsõna	B1
mineraalvesi	nimisõna	B1
mingisugune	asesõna	B1
minister	nimisõna	B1
miski	nimisõna	B1
mitmesugune	omadussõna	B1
mitmus	nimisõna	B1
modell	nimisõna	B1
monoloog	nimisõna	B1
moodi	kaassõna	B1
moodne	omadussõna	B1
moodustama	tegusõna	B1
mootorrattur	nimisõna	B1
mopeed	nimisõna	B1
mugavus	nimisõna	B1
muidu	määrsõna	B1
mujal	määrsõna	B1
mujale	määrsõna	B1
mujalt	määrsõna	B1
muld	nimisõna	B1
mulje	nimisõna	B1
mullivann	nimisõna	B1
mullune	omadussõna	B1
multikas	nimisõna	B1
munadepüha	nimisõna	B1
murdma	tegusõna	B1
murel	nimisõna	B1
murelik	omadussõna	B1
muru	nimisõna	B1
muruniiduk	nimisõna	B1
musi	nimisõna	B1
must sõstar	nimisõna	B1
muster	nimisõna	B1
mustikas	nimisõna	B1
mustsõstar	nimisõna	B1
muudatus	nimisõna	B1
muuseas	määrsõna	B1
muusik	nimisõna	B1
muusikal	nimisõna	B1
muutlik	omadussõna	B1
mõis	nimisõna	B1
mõistatus	nimisõna	B1
mõistlik	omadussõna	B1
mõistma	tegusõna	B1
mõistus	nimisõna	B1
mõju	nimisõna	B1
mõnus	omadussõna	B1
mõru	omadussõna	B1
mõrv	nimisõna	B1
mõrvar	nimisõna	B1
mõttetu	omadussõna	B1
mõõde	nimisõna	B1
mõõdukas	omadussõna	B1
mõõk	nimisõna	B1
mõõtma	tegusõna	B1
mäda	nimisõna	B1
mädarõigas	nimisõna	B1
mälestus	nimisõna	B1
mälestusmärk	nimisõna	B1
mälupulk	nimisõna	B1
mänd	nimisõna	B1
mänguväljak	nimisõna	B1
märgatavalt	määrsõna	B1
märkima	tegusõna	B1
märkus	nimisõna	B1
mäss	nimisõna	B1
määr	nimisõna	B1
määrama	tegusõna	B1
määrima	tegusõna	B1
mööda	määrsõna	B1
mööduma	tegusõna	B1
möödunud	omadussõna	B1
münt	nimisõna	B1
müra	nimisõna	B1
mürgine	omadussõna	B1
müristama	tegusõna	B1
mürk	nimisõna	B1
müür	nimisõna	B1
nael	nimisõna	B1
nagi	nimisõna	B1
naissugu	nimisõna	B1
naistearst	nimisõna	B1
naistepäev	nimisõna	B1
nakkushaigus	nimisõna	B1
napp	omadussõna	B1
nappima	tegusõna	B1
narkomaan	nimisõna	B1
narkootikum	nimisõna	B1
naturaalne	omadussõna	B1
nautima	tegusõna	B1
neelama	tegusõna	B1
neer	nimisõna	B1
neljakesi	määrsõna	B1
neljakorruseline	omadussõna	B1
neljandik	nimisõna	B1
neljandik	põhiarvsõna	B1
neljatoaline	omadussõna	B1
niikuinii	määrsõna	B1
niimoodi	määrsõna	B1
niisama	määrsõna	B1
niisiis	määrsõna	B1
niiske	omadussõna	B1
niit	nimisõna	B1
nimel	kaassõna	B1
nimeline	omadussõna	B1
nimelt	määrsõna	B1
nimetus	nimisõna	B1
nisu	nimisõna	B1
nohu	nimisõna	B1
noormees	nimisõna	B1
nooruk	nimisõna	B1
norra	käändumatu omadussõna	B1
norralane	nimisõna	B1
notar	nimisõna	B1
nukker	omadussõna	B1
nurmenukk	nimisõna	B1
nutitelefon	nimisõna	B1
nutt	nimisõna	B1
nuustik	nimisõna	B1
nõrkus	nimisõna	B1
nõu andma	tegusõna	B1
nõu pidama	tegusõna	B1
nõudlik	omadussõna	B1
nõue	nimisõna	B1
nõukogu	nimisõna	B1
nõusolek	nimisõna	B1
nõustama	tegusõna	B1
nõustuma	tegusõna	B1
nädalalõpp	nimisõna	B1
nädalapäev	nimisõna	B1
nähtus	nimisõna	B1
näidend	nimisõna	B1
näidis	nimisõna	B1
näima	tegusõna	B1
näit	nimisõna	B1
näitaja	nimisõna	B1
näitus	nimisõna	B1
näljane	omadussõna	B1
närv	nimisõna	B1
närveerima	tegusõna	B1
närviline	omadussõna	B1
näts	nimisõna	B1
nöör	nimisõna	B1
oder	nimisõna	B1
ohkama	tegusõna	B1
ohtlik	omadussõna	B1
ohutu	omadussõna	B1
ohver	nimisõna	B1
oja	nimisõna	B1
okas	nimisõna	B1
oks	nimisõna	B1
oksendama	tegusõna	B1
olenema	tegusõna	B1
oliiv	nimisõna	B1
oliiviõli	nimisõna	B1
oluliselt	määrsõna	B1
olümpiaad	nimisõna	B1
olümpiamängud	nimisõna	B1
omaette	määrsõna	B1
omakorda	määrsõna	B1
omaks võtma	tegusõna	B1
omama	tegusõna	B1
omand	nimisõna	B1
omandama	tegusõna	B1
omapärane	omadussõna	B1
omavaheline	omadussõna	B1
ometi	määrsõna	B1
ookean	nimisõna	B1
ooper	nimisõna	B1
ootamatu	omadussõna	B1
ootamatult	määrsõna	B1
ootus	nimisõna	B1
operatsioon	nimisõna	B1
optimistlik	omadussõna	B1
orel	nimisõna	B1
organ	nimisõna	B1
organism	nimisõna	B1
osaleja	nimisõna	B1
osalemine	nimisõna	B1
osaline	omadussõna	B1
osaliselt	määrsõna	B1
osavõtja	nimisõna	B1
osavõtt	nimisõna	B1
ostukeskus	nimisõna	B1
osutama	tegusõna	B1
otsa	määrsõna	B1
otsa	kaassõna	B1
otsa saama	tegusõna	B1
otsas	määrsõna	B1
otsas	kaassõna	B1
otsene	omadussõna	B1
otstarbekas	omadussõna	B1
otsustav	omadussõna	B1
ovaalne	omadussõna	B1
paanika	nimisõna	B1
paarismaja	nimisõna	B1
paarkümmend	põhiarvsõna	B1
paat	nimisõna	B1
padjapüür	nimisõna	B1
pagar	nimisõna	B1
pagas	nimisõna	B1
pahandama	tegusõna	B1
pahandus	nimisõna	B1
pahane	omadussõna	B1
paigal	määrsõna	B1
paigaldama	tegusõna	B1
paigutama	tegusõna	B1
paiknema	tegusõna	B1
paiku	kaassõna	B1
paindlik	omadussõna	B1
pakane	nimisõna	B1
pakkumine	nimisõna	B1
palavik	nimisõna	B1
paljas	omadussõna	B1
palk	nimisõna	B1
pall	nimisõna	B1
palsam	nimisõna	B1
palvetama	tegusõna	B1
pangakonto	nimisõna	B1
pankrot	nimisõna	B1
pankur	nimisõna	B1
papp	nimisõna	B1
paprika	nimisõna	B1
paragrahv	nimisõna	B1
paraku	määrsõna	B1
parandus	nimisõna	B1
paranema	tegusõna	B1
paras	omadussõna	B1
pardel	nimisõna	B1
paremalt	määrsõna	B1
parfüüm	nimisõna	B1
parkima	tegusõna	B1
parkimine	nimisõna	B1
parkimisplats	nimisõna	B1
parool	nimisõna	B1
partei	nimisõna	B1
pasta	nimisõna	B1
pastor	nimisõna	B1
paus	nimisõna	B1
peagi	määrsõna	B1
peale hakkama	tegusõna	B1
peale minema	tegusõna	B1
pealkiri	nimisõna	B1
pealtvaataja	nimisõna	B1
pealuu	nimisõna	B1
peaminister	nimisõna	B1
peamiselt	määrsõna	B1
peatama	tegusõna	B1
pediküür	nimisõna	B1
peen	omadussõna	B1
peenar	nimisõna	B1
peenike	omadussõna	B1
peenraha	nimisõna	B1
peigmees	nimisõna	B1
peitma	tegusõna	B1
peituma	tegusõna	B1
peksma	tegusõna	B1
pelmeen	nimisõna	B1
perekonnaliige	nimisõna	B1
perekonnaseis	nimisõna	B1
pereliige	nimisõna	B1
pessimistlik	omadussõna	B1
pesupulber	nimisõna	B1
petersell	nimisõna	B1
petma	tegusõna	B1
pettuma	tegusõna	B1
pettus	nimisõna	B1
pidev	omadussõna	B1
pidi	kaassõna	B1
pidulikult	määrsõna	B1
pidur	nimisõna	B1
pidurdama	tegusõna	B1
pigem	määrsõna	B1
pihlakas	nimisõna	B1
pihta	kaassõna	B1
pihta hakkama	tegusõna	B1
pihv	nimisõna	B1
piinlik	omadussõna	B1
piirama	tegusõna	B1
piisama	tegusõna	B1
piisav	omadussõna	B1
piisavalt	määrsõna	B1
pikaajaline	omadussõna	B1
pikali	määrsõna	B1
pikalt	määrsõna	B1
pikendama	tegusõna	B1
pikkus	nimisõna	B1
piklik	omadussõna	B1
piknik	nimisõna	B1
pildistama	tegusõna	B1
pilk	nimisõna	B1
pill	nimisõna	B1
piloot	nimisõna	B1
pilv	nimisõna	B1
pilvine	omadussõna	B1
pilvitu	omadussõna	B1
pime	nimisõna	B1
pimedus	nimisõna	B1
pind	nimisõna	B1
pindala	nimisõna	B1
pinge	nimisõna	B1
pingutama	tegusõna	B1
pink	nimisõna	B1
pintsel	nimisõna	B1
piparmünt	nimisõna	B1
pisar	nimisõna	B1
pisike	omadussõna	B1
plaanima	tegusõna	B1
plaat	nimisõna	B1
plahvatama	tegusõna	B1
plahvatus	nimisõna	B1
plaksutama	tegusõna	B1
planeerima	tegusõna	B1
plastmass	nimisõna	B1
pleier	nimisõna	B1
plekk	nimisõna	B1
pliiatsiteritaja	nimisõna	B1
pohl	nimisõna	B1
poks	nimisõna	B1
poliitiline	omadussõna	B1
polikliinik	nimisõna	B1
pomm	nimisõna	B1
poola	käändumatu omadussõna	B1
poolaasta	nimisõna	B1
poolakas	nimisõna	B1
pooldama	tegusõna	B1
poolest	kaassõna	B1
poolsaar	nimisõna	B1
poolt	määrsõna	B1
populaarsus	nimisõna	B1
pori	nimisõna	B1
portree	nimisõna	B1
portugali	käändumatu omadussõna	B1
portugallane	nimisõna	B1
positsioon	nimisõna	B1
post	nimisõna	B1
postiindeks	nimisõna	B1
postiljon	nimisõna	B1
postmark	nimisõna	B1
praad	nimisõna	B1
praadima	tegusõna	B1
praht	nimisõna	B1
praktiline	omadussõna	B1
praktiliselt	määrsõna	B1
preester	nimisõna	B1
preili	nimisõna	B1
pressima	tegusõna	B1
presskann	nimisõna	B1
printer	nimisõna	B1
printima	tegusõna	B1
professionaalne	omadussõna	B1
programmeerija	nimisõna	B1
projektor	nimisõna	B1
prokurör	nimisõna	B1
pronks	nimisõna	B1
pronksmedal	nimisõna	B1
proovikabiin	nimisõna	B1
protest	nimisõna	B1
protseduur	nimisõna	B1
provints	nimisõna	B1
prussakas	nimisõna	B1
prügi	nimisõna	B1
prügikast	nimisõna	B1
psühhiaater	nimisõna	B1
psühholoog	nimisõna	B1
psühholoogia	nimisõna	B1
psühholoogiline	omadussõna	B1
pudeliavaja	nimisõna	B1
puhastama	tegusõna	B1
puhastus	nimisõna	B1
puhtalt	määrsõna	B1
puhtus	nimisõna	B1
puhuma	tegusõna	B1
pulk	nimisõna	B1
pulm	nimisõna	B1
pult	nimisõna	B1
punane sõstar	nimisõna	B1
punkt	nimisõna	B1
purjus	omadussõna	B1
purjus	määrsõna	B1
purskkaev	nimisõna	B1
purunema	tegusõna	B1
purustama	tegusõna	B1
pusa	nimisõna	B1
puudu	määrsõna	B1
puudu olema	tegusõna	B1
puudus	nimisõna	B1
puudust tundma	tegusõna	B1
puudutama	tegusõna	B1
puue	nimisõna	B1
puuk	nimisõna	B1
puur	nimisõna	B1
puus	nimisõna	B1
puutuma	tegusõna	B1
puuvill	nimisõna	B1
põdema	tegusõna	B1
põgenema	tegusõna	B1
põhiharidus	nimisõna	B1
põhikool	nimisõna	B1
põhiliselt	määrsõna	B1
põhimõtteline	omadussõna	B1
põhimõtteliselt	määrsõna	B1
põhinema	tegusõna	B1
põhiseadus	nimisõna	B1
põhjal	kaassõna	B1
põhjalik	omadussõna	B1
põhjalikult	määrsõna	B1
põhjendama	tegusõna	B1
põhjendus	nimisõna	B1
põhjustama	tegusõna	B1
põld	nimisõna	B1
põletama	tegusõna	B1
põletik	nimisõna	B1
põlevkivi	nimisõna	B1
põll	nimisõna	B1
põllumees	nimisõna	B1
põlv	nimisõna	B1
põlvkond	nimisõna	B1
põrsas	nimisõna	B1
põsk	nimisõna	B1
põud	nimisõna	B1
põõsas	nimisõna	B1
päevane	omadussõna	B1
päevitama	tegusõna	B1
pähe õppima	tegusõna	B1
päikeseline	omadussõna	B1
päikeseprillid	nimisõna	B1
päikesetõus	nimisõna	B1
pärima	tegusõna	B1
pärinema	tegusõna	B1
päritolu	nimisõna	B1
pärn	nimisõna	B1
pääsema	tegusõna	B1
päästevest	nimisõna	B1
pääsuke	nimisõna	B1
pöial	nimisõna	B1
pööning	nimisõna	B1
pööre	nimisõna	B1
püha	omadussõna	B1
pühendama	tegusõna	B1
pühkima	tegusõna	B1
püsima	tegusõna	B1
püsti	määrsõna	B1
püsti tõusma	tegusõna	B1
püstitama	tegusõna	B1
püstol	nimisõna	B1
raamatupidaja	nimisõna	B1
raamatupidamine	nimisõna	B1
raba	nimisõna	B1
rabarber	nimisõna	B1
rada	nimisõna	B1
radiaator	nimisõna	B1
rahaline	omadussõna	B1
rahastama	tegusõna	B1
rahasumma	nimisõna	B1
rahaühik	nimisõna	B1
rahe	nimisõna	B1
rahuldama	tegusõna	B1
rahule jätma	tegusõna	B1
rahule jääma	tegusõna	B1
rahustama	tegusõna	B1
rahvatants	nimisõna	B1
rahvuskala	nimisõna	B1
rahvuskivi	nimisõna	B1
rahvuslik	omadussõna	B1
rahvuslill	nimisõna	B1
rahvuslind	nimisõna	B1
rahvusloom	nimisõna	B1
rahvustoit	nimisõna	B1
rahvusvaheline	omadussõna	B1
raiskama	tegusõna	B1
rajama	tegusõna	B1
rajoon	nimisõna	B1
range	omadussõna	B1
ranne	nimisõna	B1
raport	nimisõna	B1
raputama	tegusõna	B1
rase	nimisõna	B1
rase	omadussõna	B1
raskejõustik	nimisõna	B1
raskelt	määrsõna	B1
raskus	nimisõna	B1
rass	nimisõna	B1
rasv	nimisõna	B1
rasvane	omadussõna	B1
ratastool	nimisõna	B1
ratsutama	tegusõna	B1
ratsutamine	nimisõna	B1
raud	nimisõna	B1
raudne	omadussõna	B1
ravikindlustus	nimisõna	B1
ravim	nimisõna	B1
reageerima	tegusõna	B1
rebima	tegusõna	B1
redel	nimisõna	B1
reegel	nimisõna	B1
reform	nimisõna	B1
registratuur	nimisõna	B1
reguleerima	tegusõna	B1
reha	nimisõna	B1
rehv	nimisõna	B1
reis	nimisõna	B1
reisija	nimisõna	B1
reket	nimisõna	B1
reklaamima	tegusõna	B1
rekord	nimisõna	B1
relv	nimisõna	B1
remontima	tegusõna	B1
rent	nimisõna	B1
rentima	tegusõna	B1
reserveerima	tegusõna	B1
ressurss	nimisõna	B1
retsept	nimisõna	B1
ridaelamu	nimisõna	B1
rihm	nimisõna	B1
riidehoid	nimisõna	B1
riidekapp	nimisõna	B1
riidepuu	nimisõna	B1
riides olema	tegusõna	B1
riidlema	tegusõna	B1
riie	nimisõna	B1
riietus	nimisõna	B1
riigiasutus	nimisõna	B1
riigipüha	nimisõna	B1
riiklik	omadussõna	B1
riiv	nimisõna	B1
rike	nimisõna	B1
rikki	määrsõna	B1
rikkis	omadussõna	B1
rikkuma	tegusõna	B1
rikkumine	nimisõna	B1
rikkus	nimisõna	B1
ringi	määrsõna	B1
ringi jooksma	tegusõna	B1
ringi käima	tegusõna	B1
rinnahoidja	nimisõna	B1
rippuma	tegusõna	B1
ripse	nimisõna	B1
riputama	tegusõna	B1
riskima	tegusõna	B1
risti	määrsõna	B1
ristima	tegusõna	B1
ristmik	nimisõna	B1
ristsõna	nimisõna	B1
robot	nimisõna	B1
rohutirts	nimisõna	B1
romaan	nimisõna	B1
ronima	tegusõna	B1
rool	nimisõna	B1
roomama	tegusõna	B1
rosin	nimisõna	B1
rukis	nimisõna	B1
rukkilill	nimisõna	B1
rulluisud	nimisõna	B1
rulluisutamine	nimisõna	B1
rumalalt	määrsõna	B1
rumalus	nimisõna	B1
rumeenlane	nimisõna	B1
rusikas	nimisõna	B1
ruttama	tegusõna	B1
ruuduline	omadussõna	B1
ruut	nimisõna	B1
ruutmeeter	nimisõna	B1
rõdu	nimisõna	B1
rõhk	nimisõna	B1
rõivas	nimisõna	B1
rõõmsalt	määrsõna	B1
räim	nimisõna	B1
rätik	nimisõna	B1
rätsep	nimisõna	B1
röster	nimisõna	B1
röövel	nimisõna	B1
röövima	tegusõna	B1
rühmatöö	nimisõna	B1
ründama	tegusõna	B1
rünnak	nimisõna	B1
rütm	nimisõna	B1
saadik	nimisõna	B1
saadik	kaassõna	B1
saag	nimisõna	B1
saagima	tegusõna	B1
saak	nimisõna	B1
saatekiri	nimisõna	B1
saatkond	nimisõna	B1
saatus	nimisõna	B1
saavutama	tegusõna	B1
saavutus	nimisõna	B1
saba	nimisõna	B1
sadakond	nimisõna	B1
sadu	nimisõna	B1
sage	omadussõna	B1
sagedus	nimisõna	B1
saksofon	nimisõna	B1
saladus	nimisõna	B1
salaja	määrsõna	B1
salajane	omadussõna	B1
salasõna	nimisõna	B1
sale	omadussõna	B1
salong	nimisõna	B1
salvestama	tegusõna	B1
salvrätik	nimisõna	B1
samamoodi	määrsõna	B1
samas	määrsõna	B1
sandaal	nimisõna	B1
sarnanema	tegusõna	B1
sarv	nimisõna	B1
sattuma	tegusõna	B1
seade	nimisõna	B1
seaduslik	omadussõna	B1
sealhulgas	määrsõna	B1
sealne	omadussõna	B1
sealtpoolt	kaassõna	B1
seast	kaassõna	B1
seega	määrsõna	B1
seekord	määrsõna	B1
seekordne	omadussõna	B1
seeme	nimisõna	B1
seepärast	määrsõna	B1
seeria	nimisõna	B1
seespool	kaassõna	B1
seestpoolt	määrsõna	B1
segadus	nimisõna	B1
segamini	määrsõna	B1
segane	omadussõna	B1
segi	määrsõna	B1
segi ajama	tegusõna	B1
seis	nimisõna	B1
seisnema	tegusõna	B1
seisukoht	nimisõna	B1
seisund	nimisõna	B1
seitsmekorruseline	omadussõna	B1
sekkuma	tegusõna	B1
sekretär	nimisõna	B1
seksuaalne	omadussõna	B1
seletama	tegusõna	B1
seletus	nimisõna	B1
selgitama	tegusõna	B1
selgitus	nimisõna	B1
selgroog	nimisõna	B1
selguma	tegusõna	B1
selgus	nimisõna	B1
selili	määrsõna	B1
senine	omadussõna	B1
senini	määrsõna	B1
seos	nimisõna	B1
sepik	nimisõna	B1
sepp	nimisõna	B1
side	nimisõna	B1
sidekriips	nimisõna	B1
siduma	tegusõna	B1
sigaret	nimisõna	B1
siht	nimisõna	B1
sihtkoht	nimisõna	B1
sihtnumber	nimisõna	B1
siiani	määrsõna	B1
siid	nimisõna	B1
siinne	omadussõna	B1
siinsamas	määrsõna	B1
siirup	nimisõna	B1
sile	omadussõna	B1
silma paistma	tegusõna	B1
silma torkama	tegusõna	B1
silmapaistev	omadussõna	B1
silmas pidama	tegusõna	B1
sinilill	nimisõna	B1
sipelgas	nimisõna	B1
sirel	nimisõna	B1
sirge	omadussõna	B1
sirgelt	määrsõna	B1
sisaldama	tegusõna	B1
sisemine	omadussõna	B1
sisenema	tegusõna	B1
sisestama	tegusõna	B1
sisse logima	tegusõna	B1
sisse magama	tegusõna	B1
sisse murdma	tegusõna	B1
sisse saama	tegusõna	B1
sissepoole	määrsõna	B1
sissepoole	kaassõna	B1
sissetulek	nimisõna	B1
sisu	nimisõna	B1
sisukord	nimisõna	B1
skandaal	nimisõna	B1
skaneerima	tegusõna	B1
skeem	nimisõna	B1
skorpion	nimisõna	B1
skulptor	nimisõna	B1
slovakk	nimisõna	B1
sobiv	omadussõna	B1
soe	nimisõna	B1
soeng	nimisõna	B1
sokk	nimisõna	B1
solvama	tegusõna	B1
solvuma	tegusõna	B1
soo	nimisõna	B1
soodne	omadussõna	B1
soodustus	nimisõna	B1
soolane	omadussõna	B1
sooritama	tegusõna	B1
sponsor	nimisõna	B1
spordiala	nimisõna	B1
spordiklubi	nimisõna	B1
spordisaal	nimisõna	B1
spordivõistlus	nimisõna	B1
sportlik	omadussõna	B1
staadion	nimisõna	B1
stabiilne	omadussõna	B1
start	nimisõna	B1
startima	tegusõna	B1
statistika	nimisõna	B1
stiil	nimisõna	B1
stipendium	nimisõna	B1
stjuardess	nimisõna	B1
streik	nimisõna	B1
stress	nimisõna	B1
struktuur	nimisõna	B1
subtiiter	nimisõna	B1
suhe	nimisõna	B1
suhteline	omadussõna	B1
suhteliselt	määrsõna	B1
suhtes	kaassõna	B1
suhtlema	tegusõna	B1
suhtlus	nimisõna	B1
suhtuma	tegusõna	B1
suitsetama	tegusõna	B1
suitsetamine	nimisõna	B1
suitsupääsuke	nimisõna	B1
sukk	nimisõna	B1
sulama	tegusõna	B1
sularaha	nimisõna	B1
sularahaautomaat	nimisõna	B1
sulatama	tegusõna	B1
sulg	nimisõna	B1
sulgpall	nimisõna	B1
sundima	tegusõna	B1
surnud	omadussõna	B1
surnukeha	nimisõna	B1
suši	nimisõna	B1
suudlema	tegusõna	B1
suudlus	nimisõna	B1
suuline	omadussõna	B1
suunama	tegusõna	B1
suund	nimisõna	B1
suur reede	nimisõna	B1
suurendama	tegusõna	B1
suurenema	tegusõna	B1
suurepäraselt	määrsõna	B1
suusatama	tegusõna	B1
suusatamine	nimisõna	B1
suveniir	nimisõna	B1
suvila	nimisõna	B1
suvine	omadussõna	B1
sõbrapäev	nimisõna	B1
sõdur	nimisõna	B1
sõiduplaan	nimisõna	B1
sõidutama	tegusõna	B1
sõjaline	omadussõna	B1
sõjavägi	nimisõna	B1
sõlm	nimisõna	B1
sõlmima	tegusõna	B1
sõltumatu	omadussõna	B1
sõltuvalt	määrsõna	B1
sõltuvus	nimisõna	B1
sõna pidama	tegusõna	B1
sõna võtma	tegusõna	B1
sõnaraamat	nimisõna	B1
sõnastik	nimisõna	B1
sõnavara	nimisõna	B1
sõprus	nimisõna	B1
säilima	tegusõna	B1
säilitama	tegusõna	B1
säär	nimisõna	B1
sääsk	nimisõna	B1
säästma	tegusõna	B1
söökla	nimisõna	B1
söötma	tegusõna	B1
südalinn	nimisõna	B1
südamlik	omadussõna	B1
südaöö	nimisõna	B1
sügavalt	määrsõna	B1
sügavkülmik	nimisõna	B1
sügavus	nimisõna	B1
sügelema	tegusõna	B1
sügisene	omadussõna	B1
süles	määrsõna	B1
sülitama	tegusõna	B1
sült	nimisõna	B1
sünd	nimisõna	B1
sünniaeg	nimisõna	B1
sünnikoht	nimisõna	B1
sünnitama	tegusõna	B1
sünnitunnistus	nimisõna	B1
süst	nimisõna	B1
süttima	tegusõna	B1
süü	nimisõna	B1
süüdi	määrsõna	B1
süüdistama	tegusõna	B1
süüdistus	nimisõna	B1
süütama	tegusõna	B1
šampinjon	nimisõna	B1
šokk	nimisõna	B1
šotlane	nimisõna	B1
šveitslane	nimisõna	B1
žilett	nimisõna	B1
žürii	nimisõna	B1
taani	käändumatu omadussõna	B1
taanlane	nimisõna	B1
taas	määrsõna	B1
taasiseseisvumispäev	nimisõna	B1
tablett	nimisõna	B1
taga otsima	tegusõna	B1
taga rääkima	tegusõna	B1
tagajärg	nimisõna	B1
tagant	määrsõna	B1
tagant	kaassõna	B1
tagantpoolt	määrsõna	B1
tagapool	määrsõna	B1
tagasi astuma	tegusõna	B1
tagasi võtma	tegusõna	B1
tagasihoidlik	omadussõna	B1
tagastama	tegusõna	B1
tagatis	nimisõna	B1
tagavara	nimisõna	B1
tagumik	nimisõna	B1
tagurpidi	määrsõna	B1
tahapoole	määrsõna	B1
tahe	nimisõna	B1
tahke	omadussõna	B1
tahvel	nimisõna	B1
tainas	nimisõna	B1
tajuma	tegusõna	B1
takistama	tegusõna	B1
takistus	nimisõna	B1
taktika	nimisõna	B1
tald	nimisõna	B1
talje	nimisõna	B1
talunik	nimisõna	B1
talvine	omadussõna	B1
tamm	nimisõna	B1
tantsija	nimisõna	B1
tantsima	tegusõna	B1
tantsupidu	nimisõna	B1
taotlema	tegusõna	B1
taotlus	nimisõna	B1
tapeet	nimisõna	B1
tapma	tegusõna	B1
tarbima	tegusõna	B1
targalt	määrsõna	B1
tarvis	määrsõna	B1
tasa	määrsõna	B1
tasakaal	nimisõna	B1
tasand	nimisõna	B1
tasane	omadussõna	B1
taskulamp	nimisõna	B1
taskuraha	nimisõna	B1
taskurätik	nimisõna	B1
taust	nimisõna	B1
tava	nimisõna	B1
tavapärane	omadussõna	B1
teada andma	tegusõna	B1
teada saama	tegusõna	B1
teadlane	nimisõna	B1
teadlik	omadussõna	B1
teadlikult	määrsõna	B1
teadmised	nimisõna	B1
teadus	nimisõna	B1
teaduslik	omadussõna	B1
teadvus	nimisõna	B1
teatud	omadussõna	B1
teave	nimisõna	B1
teavitama	tegusõna	B1
teekann	nimisõna	B1
teekond	nimisõna	B1
teenima	tegusõna	B1
teenindama	tegusõna	B1
teenindus	nimisõna	B1
teenus	nimisõna	B1
teenustasu	nimisõna	B1
teesklema	tegusõna	B1
tegelane	nimisõna	B1
tegelik	omadussõna	B1
tegelikkus	nimisõna	B1
tegelikult	määrsõna	B1
tegu	nimisõna	B1
tegutsema	tegusõna	B1
tehnoloogia	nimisõna	B1
teiseks	määrsõna	B1
teisiti	määrsõna	B1
teismeline	nimisõna	B1
teismeline	omadussõna	B1
teistmoodi	määrsõna	B1
teistsugune	omadussõna	B1
teistsugune	asesõna	B1
tekikott	nimisõna	B1
tekitama	tegusõna	B1
tekkimine	nimisõna	B1
telefoninumber	nimisõna	B1
telekanal	nimisõna	B1
tellija	nimisõna	B1
tennis	nimisõna	B1
teos	nimisõna	B1
tera	nimisõna	B1
tera	nimisõna	B1
terminal	nimisõna	B1
tervelt	määrsõna	B1
tervitus	nimisõna	B1
testima	tegusõna	B1
tibu	nimisõna	B1
tige	omadussõna	B1
tigu	nimisõna	B1
tihane	nimisõna	B1
tihe	omadussõna	B1
tihedalt	määrsõna	B1
tiib	nimisõna	B1
tiiger	nimisõna	B1
tiitel	nimisõna	B1
tikk	nimisõna	B1
till	nimisõna	B1
tingimus	nimisõna	B1
tipp	nimisõna	B1
toetaja	nimisõna	B1
toetama	tegusõna	B1
toetus	nimisõna	B1
tohutu	omadussõna	B1
toiduõli	nimisõna	B1
toime tulema	tegusõna	B1
toimetaja	nimisõna	B1
toimetama	tegusõna	B1
toimik	nimisõna	B1
toitma	tegusõna	B1
toituma	tegusõna	B1
toitumine	nimisõna	B1
toll	nimisõna	B1
tolm	nimisõna	B1
tolmuimeja	nimisõna	B1
tolmune	omadussõna	B1
toode	nimisõna	B1
toomingas	nimisõna	B1
toon	nimisõna	B1
toorelt	määrsõna	B1
toores	omadussõna	B1
tootja	nimisõna	B1
tootma	tegusõna	B1
torkama	tegusõna	B1
tormine	omadussõna	B1
torn	nimisõna	B1
toss	nimisõna	B1
tragöödia	nimisõna	B1
trahv	nimisõna	B1
traktor	nimisõna	B1
transport	nimisõna	B1
traumapunkt	nimisõna	B1
trepikoda	nimisõna	B1
triibuline	omadussõna	B1
triikima	tegusõna	B1
triikimislaud	nimisõna	B1
triikraud	nimisõna	B1
triip	nimisõna	B1
trikoo	nimisõna	B1
trumm	nimisõna	B1
truu	omadussõna	B1
trükkima	tegusõna	B1
tsirkus	nimisõna	B1
tšehh	nimisõna	B1
tublisti	määrsõna	B1
tugevalt	määrsõna	B1
tugevasti	määrsõna	B1
tugevdama	tegusõna	B1
tugevnema	tegusõna	B1
tugevus	nimisõna	B1
tugi	nimisõna	B1
tuisk	nimisõna	B1
tuju	nimisõna	B1
tuletõrjuja	nimisõna	B1
tulevane	omadussõna	B1
tuline	omadussõna	B1
tulistama	tegusõna	B1
tulp	nimisõna	B1
tulu	nimisõna	B1
tulumaks	nimisõna	B1
tundlik	omadussõna	B1
tundmatu	omadussõna	B1
tunduma	tegusõna	B1
tunduvalt	määrsõna	B1
tungima	tegusõna	B1
tunnel	nimisõna	B1
tunnetama	tegusõna	B1
tunnistaja	nimisõna	B1
tunnistama	tegusõna	B1
tunnistus	nimisõna	B1
tunnus	nimisõna	B1
tunnustama	tegusõna	B1
tunnustus	nimisõna	B1
tuntud	omadussõna	B1
turism	nimisõna	B1
tursk	nimisõna	B1
turvaline	omadussõna	B1
turvaliselt	määrsõna	B1
turvalisus	nimisõna	B1
turvamees	nimisõna	B1
turvavöö	nimisõna	B1
tutvus	nimisõna	B1
tutvustama	tegusõna	B1
tuuline	omadussõna	B1
tuunikala	nimisõna	B1
tuvi	nimisõna	B1
tõde	nimisõna	B1
tõeline	omadussõna	B1
tõeliselt	määrsõna	B1
tõend	nimisõna	B1
tõenäoline	omadussõna	B1
tõenäoliselt	määrsõna	B1
tõepoolest	määrsõna	B1
tõlk	nimisõna	B1
tõlkija	nimisõna	B1
tõmblukk	nimisõna	B1
tõsiselt	määrsõna	B1
tõus	nimisõna	B1
tähelepanelik	omadussõna	B1
tähelepanelikult	määrsõna	B1
tähendus	nimisõna	B1
tähestik	nimisõna	B1
tähistamine	nimisõna	B1
tähtaeg	nimisõna	B1
tähtajaline	omadussõna	B1
tähtkuju	nimisõna	B1
tähtpäev	nimisõna	B1
tähtsus	nimisõna	B1
täide minema	tegusõna	B1
täide viima	tegusõna	B1
täielik	omadussõna	B1
täielikult	määrsõna	B1
täiesti	määrsõna	B1
täiskasvanu	nimisõna	B1
täiskasvanud	omadussõna	B1
tänapäev	nimisõna	B1
tänapäevane	omadussõna	B1
tänavune	omadussõna	B1
tänulik	omadussõna	B1
täpiline	omadussõna	B1
täpp	nimisõna	B1
täpsus	nimisõna	B1
täpsustama	tegusõna	B1
tööaeg	nimisõna	B1
tööandja	nimisõna	B1
tööjõud	nimisõna	B1
töökaaslane	nimisõna	B1
töökas	omadussõna	B1
tööleping	nimisõna	B1
tööluba	nimisõna	B1
tööriist	nimisõna	B1
tööstus	nimisõna	B1
töötasu	nimisõna	B1
töötlema	tegusõna	B1
töötus	nimisõna	B1
tööülesanne	nimisõna	B1
tühistama	tegusõna	B1
tüli	nimisõna	B1
tülitama	tegusõna	B1
tülitsema	tegusõna	B1
tütarlaps	nimisõna	B1
tüüp	nimisõna	B1
tüüpiline	omadussõna	B1
uba	nimisõna	B1
udu	nimisõna	B1
udune	omadussõna	B1
uisk	nimisõna	B1
uisutama	tegusõna	B1
uisutamine	nimisõna	B1
ujula	nimisõna	B1
ujumine	nimisõna	B1
ujumispüksid	nimisõna	B1
ujumisriided	nimisõna	B1
ukraina	käändumatu omadussõna	B1
ukrainlane	nimisõna	B1
ummik	nimisõna	B1
unenägu	nimisõna	B1
ungari	käändumatu omadussõna	B1
ungarlane	nimisõna	B1
unine	omadussõna	B1
unistama	tegusõna	B1
unistus	nimisõna	B1
uppuma	tegusõna	B1
usaldama	tegusõna	B1
usklik	omadussõna	B1
uskumatu	omadussõna	B1
uss	nimisõna	B1
uurima	tegusõna	B1
uurimine	nimisõna	B1
uurimus	nimisõna	B1
uuring	nimisõna	B1
uusaasta	nimisõna	B1
vaade	nimisõna	B1
vaagen	nimisõna	B1
vaal	nimisõna	B1
vaarikas	nimisõna	B1
vaatamata	kaassõna	B1
vaatamisväärsus	nimisõna	B1
vabaabielu	nimisõna	B1
vabadus	nimisõna	B1
vabalt	määrsõna	B1
vabanema	tegusõna	B1
vabastama	tegusõna	B1
vabatahtlik	omadussõna	B1
vabatahtlikult	määrsõna	B1
vabrik	nimisõna	B1
vaesus	nimisõna	B1
vaev	nimisõna	B1
vahe	nimisõna	B1
vaheaeg	nimisõna	B1
vahekord	nimisõna	B1
vahele	määrsõna	B1
vahele	kaassõna	B1
vahele jääma	tegusõna	B1
vahele segama	tegusõna	B1
vahemaa	nimisõna	B1
vahend	nimisõna	B1
vahendusel	kaassõna	B1
vahepeal	määrsõna	B1
vaher	nimisõna	B1
vahetus	nimisõna	B1
vaht	nimisõna	B1
vahva	omadussõna	B1
vaidlema	tegusõna	B1
vaidlus	nimisõna	B1
vaikima	tegusõna	B1
vaim	nimisõna	B1
vaip	nimisõna	B1
vait	määrsõna	B1
vajalikkus	nimisõna	B1
vajama	tegusõna	B1
vajutama	tegusõna	B1
vaktsiin	nimisõna	B1
vaktsineerima	tegusõna	B1
valamu	nimisõna	B1
valdama	tegusõna	B1
valdkond	nimisõna	B1
valgevenelane	nimisõna	B1
valgus	nimisõna	B1
valgusfoor	nimisõna	B1
valideerima	tegusõna	B1
valija	nimisõna	B1
valimised	nimisõna	B1
valitsema	tegusõna	B1
valitsus	nimisõna	B1
valjusti	määrsõna	B1
vallaline	nimisõna	B1
valmima	tegusõna	B1
valmis saama	tegusõna	B1
valmistamine	nimisõna	B1
valmistuma	tegusõna	B1
valusalt	määrsõna	B1
valusasti	määrsõna	B1
valvama	tegusõna	B1
valve	nimisõna	B1
valvur	nimisõna	B1
vanasti	määrsõna	B1
vanavanemad	nimisõna	B1
vang	nimisõna	B1
vanker	nimisõna	B1
vara	nimisõna	B1
varahommik	nimisõna	B1
varajane	omadussõna	B1
varane	omadussõna	B1
varas	nimisõna	B1
varastama	tegusõna	B1
varblane	nimisõna	B1
vares	nimisõna	B1
vargus	nimisõna	B1
vars	nimisõna	B1
varuosa	nimisõna	B1
varustus	nimisõna	B1
vasak	omadussõna	B1
vasikas	nimisõna	B1
vastane	nimisõna	B1
vastas	määrsõna	B1
vastas	kaassõna	B1
vastav	omadussõna	B1
vastik	omadussõna	B1
vastlapäev	nimisõna	B1
vastu hakkama	tegusõna	B1
vastu minema	tegusõna	B1
vastu pidama	tegusõna	B1
vastu vaidlema	tegusõna	B1
vastupidav	omadussõna	B1
vastupidi	määrsõna	B1
vastutama	tegusõna	B1
vatt	nimisõna	B1
vedama	tegusõna	B1
vedel	omadussõna	B1
veeb	nimisõna	B1
veebileht	nimisõna	B1
veekogu	nimisõna	B1
veemõõtja	nimisõna	B1
veerand	nimisõna	B1
veerand	põhiarvsõna	B1
veetma	tegusõna	B1
veider	omadussõna	B1
veiseliha	nimisõna	B1
venima	tegusõna	B1
veoauto	nimisõna	B1
veok	nimisõna	B1
vererõhk	nimisõna	B1
versioon	nimisõna	B1
vest	nimisõna	B1
vestlema	tegusõna	B1
vestlus	nimisõna	B1
vigastama	tegusõna	B1
vihaselt	määrsõna	B1
vihastama	tegusõna	B1
vihkama	tegusõna	B1
vihmakeep	nimisõna	B1
vihmane	omadussõna	B1
vihmapilv	nimisõna	B1
vihmauss	nimisõna	B1
viibima	tegusõna	B1
viiekorruseline	omadussõna	B1
viiendik	põhiarvsõna	B1
viil	nimisõna	B1
viirus	nimisõna	B1
viis	nimisõna	B1
viisakalt	määrsõna	B1
viitenumber	nimisõna	B1
viitsima	tegusõna	B1
viiul	nimisõna	B1
viivis	nimisõna	B1
vikerkaar	nimisõna	B1
vildikas	nimisõna	B1
vilets	omadussõna	B1
vili	nimisõna	B1
vill	nimisõna	B1
villane	omadussõna	B1
viltpliiats	nimisõna	B1
virsik	nimisõna	B1
visiit	nimisõna	B1
vistrik	nimisõna	B1
vitamiin	nimisõna	B1
volitus	nimisõna	B1
voodipesu	nimisõna	B1
voolama	tegusõna	B1
voor	nimisõna	B1
vormistama	tegusõna	B1
võidupüha	nimisõna	B1
võilill	nimisõna	B1
võim	nimisõna	B1
võimas	omadussõna	B1
võimatu	omadussõna	B1
võimeline	omadussõna	B1
võimlema	tegusõna	B1
võimlemine	nimisõna	B1
võistkond	nimisõna	B1
võistleja	nimisõna	B1
võistlema	tegusõna	B1
võitja	nimisõna	B1
võitlema	tegusõna	B1
võitlus	nimisõna	B1
võlg	nimisõna	B1
võlgu olema	tegusõna	B1
võlu	nimisõna	B1
võlur	nimisõna	B1
võrdlus	nimisõna	B1
võrdne	omadussõna	B1
võrdselt	määrsõna	B1
võrk	nimisõna	B1
võrkpall	nimisõna	B1
võti	nimisõna	B1
võtmehoidja	nimisõna	B1
võõrsõna	nimisõna	B1
vägi	nimisõna	B1
vägivald	nimisõna	B1
vähemus	nimisõna	B1
vähendama	tegusõna	B1
vähene	omadussõna	B1
vähenema	tegusõna	B1
vähenemine	nimisõna	B1
vähk	nimisõna	B1
väli	nimisõna	B1
välimus	nimisõna	B1
väline	omadussõna	B1
välismaine	omadussõna	B1
välisriik	nimisõna	B1
välja andma	tegusõna	B1
välja arvutama	tegusõna	B1
välja astuma	tegusõna	B1
välja jätma	tegusõna	B1
välja kujunema	tegusõna	B1
välja kutsuma	tegusõna	B1
välja kuulutama	tegusõna	B1
välja langema	tegusõna	B1
välja logima	tegusõna	B1
välja magama	tegusõna	B1
välja müüma	tegusõna	B1
välja näitama	tegusõna	B1
välja otsima	tegusõna	B1
välja pakkuma	tegusõna	B1
välja saatma	tegusõna	B1
välja surema	tegusõna	B1
välja tegema	tegusõna	B1
välja tulema	tegusõna	B1
välja tõmbama	tegusõna	B1
välja uurima	tegusõna	B1
välja viima	tegusõna	B1
välja üürima	tegusõna	B1
väljaanne	nimisõna	B1
väljaheide	nimisõna	B1
väljakutse	nimisõna	B1
väljaminek	nimisõna	B1
väljapoole	määrsõna	B1
väljapoole	kaassõna	B1
väljaspool	määrsõna	B1
väljaspool	kaassõna	B1
väljaspoole	nimisõna	B1
väljast	määrsõna	B1
väljastama	tegusõna	B1
väljastpoolt	määrsõna	B1
väljastpoolt	kaassõna	B1
väljavõte	nimisõna	B1
väljaõpe	nimisõna	B1
väljendama	tegusõna	B1
välk	nimisõna	B1
vältima	tegusõna	B1
värisema	tegusõna	B1
värviline	omadussõna	B1
värvipliiats	nimisõna	B1
väsima	tegusõna	B1
väsimus	nimisõna	B1
väsinud	omadussõna	B1
väärima	tegusõna	B1
väärt	omadussõna	B1
väärtus	nimisõna	B1
väärtuslik	omadussõna	B1
vöö	nimisõna	B1
vürtsikas	omadussõna	B1
õhtune	omadussõna	B1
õhtusöök	nimisõna	B1
õhtuti	määrsõna	B1
õhuke	omadussõna	B1
õhupall	nimisõna	B1
õhutemperatuur	nimisõna	B1
õieti	määrsõna	B1
õigesti	määrsõna	B1
õigeusk	nimisõna	B1
õiglane	omadussõna	B1
õitsema	tegusõna	B1
õmblema	tegusõna	B1
õmblusmasin	nimisõna	B1
õnneks	määrsõna	B1
õnnestuma	tegusõna	B1
õnnitlus	nimisõna	B1
õpe	nimisõna	B1
õpetus	nimisõna	B1
õpingud	nimisõna	B1
õppeaasta	nimisõna	B1
õppeaine	nimisõna	B1
õppejõud	nimisõna	B1
õppelaen	nimisõna	B1
õppemaks	nimisõna	B1
õppetöö	nimisõna	B1
õppimine	nimisõna	B1
õppus	nimisõna	B1
õrn	omadussõna	B1
õudne	omadussõna	B1
õues	määrsõna	B1
ähvardama	tegusõna	B1
äike	nimisõna	B1
ämber	nimisõna	B1
ämblik	nimisõna	B1
ämm	nimisõna	B1
ära arvama	tegusõna	B1
ära eksima	tegusõna	B1
ära jätma	tegusõna	B1
ära jääma	tegusõna	B1
ära leppima	tegusõna	B1
ära põlema	tegusõna	B1
ära teenima	tegusõna	B1
ära tundma	tegusõna	B1
ära ütlema	tegusõna	B1
äratama	tegusõna	B1
äratuskell	nimisõna	B1
ärevus	nimisõna	B1
äädikas	nimisõna	B1
äär	nimisõna	B1
äärde	kaassõna	B1
ääres	kaassõna	B1
äärest	kaassõna	B1
äärmiselt	määrsõna	B1
öine	omadussõna	B1
ööbima	tegusõna	B1
öökapp	nimisõna	B1
ööklubi	nimisõna	B1
öökull	nimisõna	B1
ööseks	määrsõna	B1
öösiti	määrsõna	B1
ühekordne	omadussõna	B1
ühekorruseline	omadussõna	B1
üheksakorruseline	omadussõna	B1
ühend	nimisõna	B1
ühendama	tegusõna	B1
ühesuunaline	omadussõna	B1
ühetoaline	omadussõna	B1
ühine	omadussõna	B1
ühinema	tegusõna	B1
ühing	nimisõna	B1
ühiskondlik	omadussõna	B1
ühistransport	nimisõna	B1
ühtlane	omadussõna	B1
üksi	määrsõna	B1
üksik	omadussõna	B1
üksinda	määrsõna	B1
ükskord	määrsõna	B1
ükskõikne	omadussõna	B1
ülal	määrsõna	B1
ülalpool	määrsõna	B1
ülalpool	kaassõna	B1
ülaltpoolt	määrsõna	B1
üldine	omadussõna	B1
üldiselt	määrsõna	B1
üle elama	tegusõna	B1
üle hindama	tegusõna	B1
üle jääma	tegusõna	B1
üle kandma	tegusõna	B1
üle minema	tegusõna	B1
üle vaatama	tegusõna	B1
üle viima	tegusõna	B1
üle-eelmine	omadussõna	B1
üleeelmine	omadussõna	B1
ülehomme	määrsõna	B1
ülejärgmine	omadussõna	B1
ülejäänu	nimisõna	B1
ülekanne	nimisõna	B1
ülekäigurada	nimisõna	B1
ülemus	nimisõna	B1
üles ehitama	tegusõna	B1
üles kasvama	tegusõna	B1
üles kasvatama	tegusõna	B1
üles kutsuma	tegusõna	B1
üles laadima	tegusõna	B1
üles lugema	tegusõna	B1
üles panema	tegusõna	B1
üles tunnistama	tegusõna	B1
üles tõusma	tegusõna	B1
üles äratama	tegusõna	B1
üles ärkama	tegusõna	B1
ülespoole	määrsõna	B1
ülestõusmispühad	nimisõna	B1
üleujutus	nimisõna	B1
ülevaade	nimisõna	B1
ülevaatus	nimisõna	B1
üleval	määrsõna	B1
ülevalpool	määrsõna	B1
ülevalt	määrsõna	B1
ülikool	nimisõna	B1
üllatuma	tegusõna	B1
üllatunud	omadussõna	B1
üllatus	nimisõna	B1
ümar	omadussõna	B1
ümber ajama	tegusõna	B1
ümber istuma	tegusõna	B1
ümber jutustama	tegusõna	B1
ümber mõtlema	tegusõna	B1
ümber pöörama	tegusõna	B1
ümber tegema	tegusõna	B1
ümbermõõt	nimisõna	B1
ümbrik	nimisõna	B1
ümbritsema	tegusõna	B1
ümbrus	nimisõna	B1
ümmargune	omadussõna	B1
üritus	nimisõna	B1
üsna	määrsõna	B1
üürima	tegusõna	B1
üürnik	nimisõna	B1
