aadlik	nimisõna	B2
aare	nimisõna	B2
aas	nimisõna	B2
aastakäik	nimisõna	B2
aastakümme	nimisõna	B2
aastaringselt	määrsõna	B2
aastasada	nimisõna	B2
aastatuhat	nimisõna	B2
aatom	nimisõna	B2
abikõlblik	omadussõna	B2
abiline	nimisõna	B2
abipalve	nimisõna	B2
abipolitseinik	nimisõna	B2
abitu	omadussõna	B2
abiturient	nimisõna	B2
abitus	nimisõna	B2
abivahend	nimisõna	B2
abivajaja	nimisõna	B2
abort	nimisõna	B2
absoluutne	omadussõna	B2
absoluutselt	määrsõna	B2
abstraktne	omadussõna	B2
absurd	nimisõna	B2
absurdne	omadussõna	B2
adekvaatne	omadussõna	B2
administratiivne	omadussõna	B2
administratsioon	nimisõna	B2
admiral	nimisõna	B2
adrenaliin	nimisõna	B2
adressaat	nimisõna	B2
adresseerima	tegusõna	B2
advent	nimisõna	B2
aeganõudev	omadussõna	B2
aeglustama	tegusõna	B2
aeglustuma	tegusõna	B2
aeguma	tegusõna	B2
afäär	nimisõna	B2
agentuur	nimisõna	B2
agressiivselt	määrsõna	B2
agressiivsus	nimisõna	B2
agressioon	nimisõna	B2
ahel	nimisõna	B2
ahistama	tegusõna	B2
ahne	omadussõna	B2
ahnus	nimisõna	B2
ahvatlema	tegusõna	B2
ahvima	tegusõna	B2
aiandus	nimisõna	B2
aina	määrsõna	B2
aineline	omadussõna	B2
ainestik	nimisõna	B2
ainulaadne	omadussõna	B2
ainuvõimalik	omadussõna	B2
ainuõige	omadussõna	B2
ainuüksi	määrsõna	B2
ait	nimisõna	B2
ajajärk	nimisõna	B2
ajakohane	omadussõna	B2
ajakohastama	tegusõna	B2
ajaline	omadussõna	B2
ajaliselt	määrsõna	B2
ajastama	tegusõna	B2
ajastu	nimisõna	B2
ajateenija	nimisõna	B2
ajateenistus	nimisõna	B2
ajaviide	nimisõna	B2
ajupesu	nimisõna	B2
ajurünnak	nimisõna	B2
akadeemia	nimisõna	B2
akadeemik	nimisõna	B2
akadeemiline	omadussõna	B2
aksessuaar	nimisõna	B2
akt	nimisõna	B2
aktiveerima	tegusõna	B2
aktivist	nimisõna	B2
aktsent	nimisõna	B2
aktsepteerima	tegusõna	B2
aktseptima	tegusõna	B2
aktsiis	nimisõna	B2
aktsionär	nimisõna	B2
aktsioon	nimisõna	B2
aktuaalne	omadussõna	B2
akustiline	omadussõna	B2
alahindama	tegusõna	B2
alaliselt	määrsõna	B2
alam	nimisõna	B2
alanema	tegusõna	B2
alateadlik	omadussõna	B2
alateadlikult	määrsõna	B2
alateadvus	nimisõna	B2
alatine	omadussõna	B2
alatu	omadussõna	B2
alev	nimisõna	B2
alevik	nimisõna	B2
algne	omadussõna	B2
algoritm	nimisõna	B2
algupärane	omadussõna	B2
alimendid	nimisõna	B2
alistama	tegusõna	B2
alistuma	tegusõna	B2
alkoholism	nimisõna	B2
alla jääma	tegusõna	B2
allakirjutanu	nimisõna	B2
allakäik	nimisõna	B2
allee	nimisõna	B2
allergiline	omadussõna	B2
allianss	nimisõna	B2
allilm	nimisõna	B2
alljärgnev	omadussõna	B2
allkirjastama	tegusõna	B2
allutama	tegusõna	B2
alluvus	nimisõna	B2
alpaka	nimisõna	B2
alt vedama	tegusõna	B2
altar	nimisõna	B2
alternatiivne	omadussõna	B2
altkäemaks	nimisõna	B2
alusetu	omadussõna	B2
alustus	nimisõna	B2
amatöör	nimisõna	B2
ambitsioon	nimisõna	B2
ambitsioonikas	omadussõna	B2
ambulatoorne	omadussõna	B2
ametijuhend	nimisõna	B2
ametiühing	nimisõna	B2
amfetamiin	nimisõna	B2
ammendama	tegusõna	B2
ammenduma	tegusõna	B2
ammune	omadussõna	B2
ammutama	tegusõna	B2
analoogne	omadussõna	B2
analüütik	nimisõna	B2
analüütiline	omadussõna	B2
anarhia	nimisõna	B2
anatoomia	nimisõna	B2
andekus	nimisõna	B2
andestus	nimisõna	B2
andmebaas	nimisõna	B2
andur	nimisõna	B2
animatsioon	nimisõna	B2
ankur	nimisõna	B2
anne	nimisõna	B2
annetaja	nimisõna	B2
annetama	tegusõna	B2
annetus	nimisõna	B2
anonüümne	omadussõna	B2
anonüümsus	nimisõna	B2
antikeha	nimisõna	B2
antiloop	nimisõna	B2
antonüüm	nimisõna	B2
anum	nimisõna	B2
aparaat	nimisõna	B2
aparatuur	nimisõna	B2
aplaus	nimisõna	B2
apostel	nimisõna	B2
areen	nimisõna	B2
arendus	nimisõna	B2
arendustöö	nimisõna	B2
arest	nimisõna	B2
arestima	tegusõna	B2
aretama	tegusõna	B2
argipäev	nimisõna	B2
arglik	omadussõna	B2
argument	nimisõna	B2
argumenteerima	tegusõna	B2
arhailine	omadussõna	B2
arheoloog	nimisõna	B2
arheoloogiline	omadussõna	B2
arhitektuur	nimisõna	B2
arhitektuurne	omadussõna	B2
aristokraat	nimisõna	B2
armastusväärne	omadussõna	B2
armukade	omadussõna	B2
armukadedus	nimisõna	B2
armulaud	nimisõna	B2
aroom	nimisõna	B2
arreteerima	tegusõna	B2
arsenal	nimisõna	B2
aruandlus	nimisõna	B2
arusaamatus	nimisõna	B2
arust	kaassõna	B2
arutus	nimisõna	B2
arvel	kaassõna	B2
arveldama	tegusõna	B2
arveldusarve	nimisõna	B2
arvelduskonto	nimisõna	B2
arvele	kaassõna	B2
arvelt	kaassõna	B2
arvesti	nimisõna	B2
arvestuslik	omadussõna	B2
arvukalt	määrsõna	B2
arvukas	omadussõna	B2
arvukus	nimisõna	B2
arvustama	tegusõna	B2
arvustus	nimisõna	B2
arvutus	nimisõna	B2
aseesimees	nimisõna	B2
asend	nimisõna	B2
asendamatu	omadussõna	B2
asenduma	tegusõna	B2
asetus	nimisõna	B2
asetäitja	nimisõna	B2
asjaajamiskeel	nimisõna	B2
asjakohane	omadussõna	B2
asjaomane	omadussõna	B2
asjata	määrsõna	B2
asjatult	määrsõna	B2
asjatundlik	omadussõna	B2
asotsiaal	nimisõna	B2
aspekt	nimisõna	B2
assamblee	nimisõna	B2
assistent	nimisõna	B2
asteroid	nimisõna	B2
astma	nimisõna	B2
astmeline	omadussõna	B2
astroloog	nimisõna	B2
astroloogia	nimisõna	B2
astronaut	nimisõna	B2
astronoom	nimisõna	B2
astronoomia	nimisõna	B2
asukas	nimisõna	B2
asula	nimisõna	B2
asum	nimisõna	B2
asundus	nimisõna	B2
asupaik	nimisõna	B2
asustama	tegusõna	B2
asustus	nimisõna	B2
ateist	nimisõna	B2
atesteerima	tegusõna	B2
atleet	nimisõna	B2
atmosfäär	nimisõna	B2
atraktiivne	omadussõna	B2
auahne	omadussõna	B2
auasi	nimisõna	B2
auaste	nimisõna	B2
audiitor	nimisõna	B2
audit	nimisõna	B2
auditoorium	nimisõna	B2
auhindama	tegusõna	B2
aukartus	nimisõna	B2
aukiri	nimisõna	B2
auklik	omadussõna	B2
auliige	nimisõna	B2
aumärk	nimisõna	B2
aur	nimisõna	B2
aura	nimisõna	B2
ausammas	nimisõna	B2
austaja	nimisõna	B2
ausus	nimisõna	B2
ausõna	nimisõna	B2
autasu	nimisõna	B2
autasustama	tegusõna	B2
autentne	omadussõna	B2
autogramm	nimisõna	B2
autonoomia	nimisõna	B2
autonoomne	omadussõna	B2
autoritaarne	omadussõna	B2
autoriteet	nimisõna	B2
autoriteetne	omadussõna	B2
autoriõigus	nimisõna	B2
auväärne	omadussõna	B2
ava	nimisõna	B2
avalik-õiguslik	omadussõna	B2
avalikkus	nimisõna	B2
avameelne	omadussõna	B2
avardama	tegusõna	B2
avarus	nimisõna	B2
avastus	nimisõna	B2
avatus	nimisõna	B2
baas	nimisõna	B2
bakalaureus	nimisõna	B2
ball	nimisõna	B2
ballaad	nimisõna	B2
bandiit	nimisõna	B2
bankett	nimisõna	B2
barjäär	nimisõna	B2
baseeruma	tegusõna	B2
bass	nimisõna	B2
bassein	nimisõna	B2
biennaal	nimisõna	B2
bilanss	nimisõna	B2
biljon	põhiarvsõna	B2
binokkel	nimisõna	B2
biograafia	nimisõna	B2
blogi	nimisõna	B2
blogima	tegusõna	B2
blokeerima	tegusõna	B2
blokk	nimisõna	B2
boks	nimisõna	B2
boonus	nimisõna	B2
boss	nimisõna	B2
botas	nimisõna	B2
brauser	nimisõna	B2
breketid	nimisõna	B2
britt	nimisõna	B2
broneering	nimisõna	B2
bränd	nimisõna	B2
brändi	nimisõna	B2
budism	nimisõna	B2
buum	nimisõna	B2
börs	nimisõna	B2
bürokraat	nimisõna	B2
bürokraatia	nimisõna	B2
bürokraatlik	omadussõna	B2
daalia	nimisõna	B2
dattel	nimisõna	B2
debatt	nimisõna	B2
deebetkaart	nimisõna	B2
deemon	nimisõna	B2
defekt	nimisõna	B2
definitsioon	nimisõna	B2
defitsiit	nimisõna	B2
deklaratsioon	nimisõna	B2
deklareerima	tegusõna	B2
dekoratiivne	omadussõna	B2
dekoratsioon	nimisõna	B2
delegaat	nimisõna	B2
delegeerima	tegusõna	B2
delfiin	nimisõna	B2
delikaatne	omadussõna	B2
demograafiline	omadussõna	B2
demokraat	nimisõna	B2
demonstratsioon	nimisõna	B2
demonstreerima	tegusõna	B2
deposiit	nimisõna	B2
depressioon	nimisõna	B2
detailne	omadussõna	B2
detailselt	määrsõna	B2
detektiiv	nimisõna	B2
diabeet	nimisõna	B2
diagnoos	nimisõna	B2
diagnoosima	tegusõna	B2
diagonaal	nimisõna	B2
diameeter	nimisõna	B2
diiler	nimisõna	B2
diisel	nimisõna	B2
diktaator	nimisõna	B2
diktatuur	nimisõna	B2
dikteerima	tegusõna	B2
dilemma	nimisõna	B2
dinosaurus	nimisõna	B2
diplomaatia	nimisõna	B2
direktiiv	nimisõna	B2
dirigeerima	tegusõna	B2
disainima	tegusõna	B2
diskrimineerima	tegusõna	B2
diskuteerima	tegusõna	B2
dissident	nimisõna	B2
distsipliin	nimisõna	B2
dividend	nimisõna	B2
divisjon	nimisõna	B2
dogma	nimisõna	B2
doktoritöö	nimisõna	B2
doktriin	nimisõna	B2
dokumentatsioon	nimisõna	B2
dokumenteerima	tegusõna	B2
domeen	nimisõna	B2
domineerima	tegusõna	B2
doonor	nimisõna	B2
doos	nimisõna	B2
doping	nimisõna	B2
dotsent	nimisõna	B2
draakon	nimisõna	B2
dramaatiline	omadussõna	B2
džäss	nimisõna	B2
duell	nimisõna	B2
duett	nimisõna	B2
dünaamika	nimisõna	B2
dünaamiline	omadussõna	B2
dünastia	nimisõna	B2
eakaaslane	nimisõna	B2
eakas	omadussõna	B2
ebaloomulik	omadussõna	B2
ebameeldivus	nimisõna	B2
ebamugavus	nimisõna	B2
ebamäärane	omadussõna	B2
ebasoodne	omadussõna	B2
ebastabiilsus	nimisõna	B2
ebatõenäoline	omadussõna	B2
ebatäpsus	nimisõna	B2
ebavõrdne	omadussõna	B2
ebavõrdsus	nimisõna	B2
ebaõiglus	nimisõna	B2
ebaõnn	nimisõna	B2
edasiminek	nimisõna	B2
edasine	omadussõna	B2
edaspidine	omadussõna	B2
edendama	tegusõna	B2
edenema	tegusõna	B2
edestama	tegusõna	B2
edetabel	nimisõna	B2
edukamalt	määrsõna	B2
edukus	nimisõna	B2
edumeelne	omadussõna	B2
edusamm	nimisõna	B2
edutama	tegusõna	B2
eelarveline	omadussõna	B2
eelkäija	nimisõna	B2
eelmainitud	omadussõna	B2
eelmüük	nimisõna	B2
eelnev	omadussõna	B2
eelnevalt	määrsõna	B2
eelnõu	nimisõna	B2
eelolev	omadussõna	B2
eelpool	määrsõna	B2
eelseisev	omadussõna	B2
eeltöö	nimisõna	B2
eemalduma	tegusõna	B2
eemalt	määrsõna	B2
eesistuja	nimisõna	B2
eesistumine	nimisõna	B2
eeskujulik	omadussõna	B2
eessõna	nimisõna	B2
eestimaalane	nimisõna	B2
eestimaine	omadussõna	B2
eestlus	nimisõna	B2
eestvedaja	nimisõna	B2
eesõigus	nimisõna	B2
eeter	nimisõna	B2
eeterlik	omadussõna	B2
eetiline	omadussõna	B2
efektne	omadussõna	B2
ego	nimisõna	B2
ehe	omadussõna	B2
ehmatus	nimisõna	B2
ehmuma	tegusõna	B2
ehtima	tegusõna	B2
ehtne	omadussõna	B2
eine	nimisõna	B2
eit	nimisõna	B2
eitav	omadussõna	B2
eitus	nimisõna	B2
eksemplar	nimisõna	B2
eksimus	nimisõna	B2
eksisteerima	tegusõna	B2
eksitama	tegusõna	B2
eksklusiivne	omadussõna	B2
ekslema	tegusõna	B2
ekslik	omadussõna	B2
ekslikult	määrsõna	B2
eksootiline	omadussõna	B2
ekspeditsioon	nimisõna	B2
eksperiment	nimisõna	B2
eksperimentaalne	omadussõna	B2
eksperimenteerima	tegusõna	B2
ekspertiis	nimisõna	B2
eksponaat	nimisõna	B2
eksponeerima	tegusõna	B2
eksport	nimisõna	B2
eksportima	tegusõna	B2
ekspositsioon	nimisõna	B2
ekstrakt	nimisõna	B2
ekstreemne	omadussõna	B2
elamispind	nimisõna	B2
elamistingimused	nimisõna	B2
elamus	nimisõna	B2
elastne	omadussõna	B2
elatis	nimisõna	B2
elatustase	nimisõna	B2
elavdama	tegusõna	B2
elavnema	tegusõna	B2
elegantne	omadussõna	B2
elektrilühis	nimisõna	B2
elektriseade	nimisõna	B2
elementaarne	omadussõna	B2
eliit	nimisõna	B2
elitaarne	omadussõna	B2
eluaegne	omadussõna	B2
eluase	nimisõna	B2
eluhoiak	nimisõna	B2
eluiga	nimisõna	B2
elujõuline	omadussõna	B2
elukeskkond	nimisõna	B2
elukestev	omadussõna	B2
elukutseline	omadussõna	B2
elulaad	nimisõna	B2
eluline	omadussõna	B2
eluliselt	määrsõna	B2
elund	nimisõna	B2
elurõõmus	omadussõna	B2
elustama	tegusõna	B2
elutsema	tegusõna	B2
elutu	omadussõna	B2
eluvõõras	omadussõna	B2
emakas	nimisõna	B2
emapalk	nimisõna	B2
emapuhkus	nimisõna	B2
emiteerima	tegusõna	B2
emotsionaalsus	nimisõna	B2
empaatia	nimisõna	B2
enamjaolt	määrsõna	B2
enampakkumine	nimisõna	B2
endamisi	määrsõna	B2
energeetika	nimisõna	B2
energeetiline	omadussõna	B2
energiaallikas	nimisõna	B2
energiasäästlik	omadussõna	B2
enesehinnang	nimisõna	B2
enesetapp	nimisõna	B2
eneseteadvus	nimisõna	B2
enesetäiendamine	nimisõna	B2
eneseusk	nimisõna	B2
eneseväljendus	nimisõna	B2
eneseväärikus	nimisõna	B2
ennatlik	omadussõna	B2
enneaegne	omadussõna	B2
ennekõike	määrsõna	B2
ennelõuna	nimisõna	B2
ennem	määrsõna	B2
ennetama	tegusõna	B2
ennetus	nimisõna	B2
ennetähtaegne	omadussõna	B2
ennustus	nimisõna	B2
ent	sidesõna	B2
entsüklopeedia	nimisõna	B2
entusiasm	nimisõna	B2
entusiast	nimisõna	B2
epideemia	nimisõna	B2
episood	nimisõna	B2
eraisik	nimisõna	B2
erakogu	nimisõna	B2
erakordne	omadussõna	B2
erakordselt	määrsõna	B2
eraldatus	nimisõna	B2
eraldis	nimisõna	B2
eralduma	tegusõna	B2
eramu	nimisõna	B2
eranditult	määrsõna	B2
erandkorras	määrsõna	B2
erandkorrras	määrsõna	B2
erandlik	omadussõna	B2
eraomand	nimisõna	B2
erastama	tegusõna	B2
eraõiguslik	omadussõna	B2
ere	omadussõna	B2
ergutama	tegusõna	B2
eriarst	nimisõna	B2
eriarvamus	nimisõna	B2
erikool	nimisõna	B2
eriliselt	määrsõna	B2
erimeelsus	nimisõna	B2
eriolukord	nimisõna	B2
eriotstarbeline	omadussõna	B2
eripärane	omadussõna	B2
eristuma	tegusõna	B2
erisugune	omadussõna	B2
erisus	nimisõna	B2
eritama	tegusõna	B2
erivajadus	nimisõna	B2
erk	omadussõna	B2
erootiline	omadussõna	B2
erutama	tegusõna	B2
erutus	nimisõna	B2
esietenduma	tegusõna	B2
esietendus	nimisõna	B2
esilinastuma	tegusõna	B2
esilinastus	nimisõna	B2
esindatus	nimisõna	B2
esinduslik	omadussõna	B2
esiplaanil	määrsõna	B2
esiplaanile	määrsõna	B2
esirinnas	määrsõna	B2
esitlus	nimisõna	B2
esivanem	nimisõna	B2
esmakordne	omadussõna	B2
esmatähtis	omadussõna	B2
essee	nimisõna	B2
esteetika	nimisõna	B2
esteetiline	omadussõna	B2
etendama	tegusõna	B2
etikett	nimisõna	B2
etikett	nimisõna	B2
etniline	omadussõna	B2
ette kirjutama	tegusõna	B2
ettearvamatu	omadussõna	B2
etteaste	nimisõna	B2
etteheide	nimisõna	B2
ettekirjutus	nimisõna	B2
ettekääne	nimisõna	B2
ettemaks	nimisõna	B2
ettemakse	nimisõna	B2
ettenägelik	omadussõna	B2
ettenägematu	omadussõna	B2
ettenähtud	omadussõna	B2
ettevaatlikkus	nimisõna	B2
ettevõtlik	omadussõna	B2
ettevõtlikkus	nimisõna	B2
ettevõtlus	nimisõna	B2
etteütlus	nimisõna	B2
evakueerima	tegusõna	B2
evangeelium	nimisõna	B2
evolutsioon	nimisõna	B2
faas	nimisõna	B2
faktiline	omadussõna	B2
faktor	nimisõna	B2
fanaatik	nimisõna	B2
fantaasia	nimisõna	B2
fantaseerima	tegusõna	B2
fantastiline	omadussõna	B2
fassaad	nimisõna	B2
favoriit	nimisõna	B2
feminist	nimisõna	B2
fenomen	nimisõna	B2
figureerima	tegusõna	B2
figuur	nimisõna	B2
fikseerima	tegusõna	B2
fiktiivne	omadussõna	B2
filiaal	nimisõna	B2
filoloog	nimisõna	B2
filoloogia	nimisõna	B2
filosoof	nimisõna	B2
filosoofia	nimisõna	B2
filosoofiline	omadussõna	B2
filter	nimisõna	B2
finalist	nimisõna	B2
flamingo	nimisõna	B2
folkloor	nimisõna	B2
fookus	nimisõna	B2
foolium	nimisõna	B2
foorum	nimisõna	B2
formaalne	omadussõna	B2
formaalselt	määrsõna	B2
formaalsus	nimisõna	B2
formaat	nimisõna	B2
formuleerima	tegusõna	B2
fraas	nimisõna	B2
fraktsioon	nimisõna	B2
fuajee	nimisõna	B2
funktsionaalne	omadussõna	B2
funktsionaalsus	nimisõna	B2
funktsioneerima	tegusõna	B2
föderatsioon	nimisõna	B2
füsioloogiline	omadussõna	B2
füüsik	nimisõna	B2
füüsikaline	omadussõna	B2
füüsiliselt	määrsõna	B2
galaktika	nimisõna	B2
geen	nimisõna	B2
geenius	nimisõna	B2
gei	nimisõna	B2
geneetiline	omadussõna	B2
generaator	nimisõna	B2
genereerima	tegusõna	B2
geniaalne	omadussõna	B2
genotsiid	nimisõna	B2
geoloog	nimisõna	B2
geoloogiline	omadussõna	B2
geomeetriline	omadussõna	B2
gepard	nimisõna	B2
gladiool	nimisõna	B2
glamuurne	omadussõna	B2
globaalne	omadussõna	B2
globaliseeruma	tegusõna	B2
gloobus	nimisõna	B2
glükoos	nimisõna	B2
golf	nimisõna	B2
graafika	nimisõna	B2
graafiline	omadussõna	B2
granaat	nimisõna	B2
graniit	nimisõna	B2
grimass	nimisõna	B2
grupeering	nimisõna	B2
guugeldama	tegusõna	B2
gümnasist	nimisõna	B2
haab	nimisõna	B2
haagis	nimisõna	B2
haakuma	tegusõna	B2
haarama	tegusõna	B2
haare	nimisõna	B2
haavama	tegusõna	B2
haavand	nimisõna	B2
hagi	nimisõna	B2
haigestuma	tegusõna	B2
haiglane	omadussõna	B2
haigutama	tegusõna	B2
haisema	tegusõna	B2
hajameelsus	nimisõna	B2
hakkaja	omadussõna	B2
hakkima	tegusõna	B2
halastama	tegusõna	B2
halastamatu	omadussõna	B2
halastus	nimisõna	B2
haldama	tegusõna	B2
haldjas	nimisõna	B2
haldur	nimisõna	B2
haldus	nimisõna	B2
haldusala	nimisõna	B2
hale	omadussõna	B2
haljastus	nimisõna	B2
hallitus	nimisõna	B2
halvama	tegusõna	B2
halvatus	nimisõna	B2
halvendama	tegusõna	B2
halvustama	tegusõna	B2
hang	nimisõna	B2
hange	nimisõna	B2
hantel	nimisõna	B2
hape	nimisõna	B2
hapnik	nimisõna	B2
happeline	omadussõna	B2
hapukas	omadussõna	B2
harf	nimisõna	B2
hargnema	tegusõna	B2
hari (tipmine osa)	nimisõna	B2
hariduslik	omadussõna	B2
harimatu	omadussõna	B2
haritlane	nimisõna	B2
haritud	omadussõna	B2
haritus	nimisõna	B2
harjumatu	omadussõna	B2
harjumuspärane	omadussõna	B2
harmoonia	nimisõna	B2
harmooniline	omadussõna	B2
harrastus	nimisõna	B2
haru	nimisõna	B2
harukordne	omadussõna	B2
harv	omadussõna	B2
hasartmäng	nimisõna	B2
headus	nimisõna	B2
heakord	nimisõna	B2
heakskiit	nimisõna	B2
heaolu	nimisõna	B2
heasüdamlik	omadussõna	B2
heatahtlik	omadussõna	B2
heategevuslik	omadussõna	B2
heategu	nimisõna	B2
heegeldama	tegusõna	B2
heide	nimisõna	B2
heiskama	tegusõna	B2
heitgaas	nimisõna	B2
heitlik	omadussõna	B2
hekk	nimisõna	B2
hektar	nimisõna	B2
heledus	nimisõna	B2
helendama	tegusõna	B2
helge	omadussõna	B2
helin	nimisõna	B2
heliplaat	nimisõna	B2
hell	omadussõna	B2
hellitama	tegusõna	B2
heroiin	nimisõna	B2
hetkeseis	nimisõna	B2
hierarhia	nimisõna	B2
higine	omadussõna	B2
hiigelsuur	omadussõna	B2
hiiglane	nimisõna	B2
hiiglaslik	omadussõna	B2
hiilgama	tegusõna	B2
hiilgus	nimisõna	B2
hiilima	tegusõna	B2
hiis	nimisõna	B2
hiljaaegu	määrsõna	B2
hiljemalt	määrsõna	B2
himu	nimisõna	B2
hindamatu	omadussõna	B2
hing	nimisõna	B2
hingeline	omadussõna	B2
hinnaalandus	nimisõna	B2
hinnakiri	nimisõna	B2
hinnaline	omadussõna	B2
hinnanguline	omadussõna	B2
hinnanguliselt	määrsõna	B2
hinnapakkumine	nimisõna	B2
hinnatud	omadussõna	B2
hirmsasti	määrsõna	B2
hirmuma	tegusõna	B2
hirmus	määrsõna	B2
hirmutav	omadussõna	B2
hirv	nimisõna	B2
hitt	nimisõna	B2
hoid	nimisõna	B2
hoidis	nimisõna	B2
hoidla	nimisõna	B2
hoiduma	tegusõna	B2
hoius	nimisõna	B2
hoiustama	tegusõna	B2
hommikuti	määrsõna	B2
homoseksuaal	nimisõna	B2
homoseksuaalne	omadussõna	B2
homoseksuaalsus	nimisõna	B2
hoog	nimisõna	B2
hoogne	omadussõna	B2
hoogsalt	määrsõna	B2
hooldama	tegusõna	B2
hooldekodu	nimisõna	B2
hooldus	nimisõna	B2
hooldustöö	nimisõna	B2
hoolekogu	nimisõna	B2
hooletu	omadussõna	B2
hooletus	nimisõna	B2
hoolikalt	määrsõna	B2
hoolikas	omadussõna	B2
hoolimatu	omadussõna	B2
hoolimatus	nimisõna	B2
hoolitsus	nimisõna	B2
hooliv	omadussõna	B2
hoolivus	nimisõna	B2
hoolsus	nimisõna	B2
hoonestus	nimisõna	B2
hoop	nimisõna	B2
hooplema	tegusõna	B2
hoov	nimisõna	B2
hoovihm	nimisõna	B2
horisont	nimisõna	B2
horisontaalne	omadussõna	B2
hormonaalne	omadussõna	B2
hormoon	nimisõna	B2
horoskoop	nimisõna	B2
hubane	omadussõna	B2
hukk	nimisõna	B2
hukka	määrsõna	B2
hukkama	tegusõna	B2
hukutama	tegusõna	B2
hulga	määrsõna	B2
hulgaliselt	määrsõna	B2
hulgi	määrsõna	B2
hulgimüük	nimisõna	B2
huligaan	nimisõna	B2
hulkuma	tegusõna	B2
hullult	määrsõna	B2
hullumaja	nimisõna	B2
hullumeelne	omadussõna	B2
hullumeelsus	nimisõna	B2
hullus	nimisõna	B2
hullusti	määrsõna	B2
humaanne	omadussõna	B2
humoorikas	omadussõna	B2
hundinui	nimisõna	B2
hunnik	nimisõna	B2
huumorimeel	nimisõna	B2
huviharidus	nimisõna	B2
huvipakkuv	omadussõna	B2
huvitegevus	nimisõna	B2
huvituma	tegusõna	B2
huviväärsus	nimisõna	B2
hõim	nimisõna	B2
hõivama	tegusõna	B2
hõivatud	omadussõna	B2
hõlbus	omadussõna	B2
hõlbustama	tegusõna	B2
hõljuma	tegusõna	B2
hõlmama	tegusõna	B2
hõlpsasti	määrsõna	B2
hõre	omadussõna	B2
hõrenema	tegusõna	B2
hõrk	omadussõna	B2
hõõruma	tegusõna	B2
häbiväärne	omadussõna	B2
hädaldama	tegusõna	B2
hädaolukord	nimisõna	B2
hädapärane	omadussõna	B2
hägune	omadussõna	B2
häkker	nimisõna	B2
häll	nimisõna	B2
hämarik	nimisõna	B2
hämarus	nimisõna	B2
hämmastama	tegusõna	B2
hämmastav	omadussõna	B2
hämmastavalt	määrsõna	B2
härg	nimisõna	B2
härrasmees	nimisõna	B2
hävinema	tegusõna	B2
häving	nimisõna	B2
hääbuma	tegusõna	B2
hääldus	nimisõna	B2
häälekas	omadussõna	B2
hääleõigus	nimisõna	B2
hääleõiguslik	omadussõna	B2
hüatsint	nimisõna	B2
hübriid	nimisõna	B2
hügieen	nimisõna	B2
hüljes	nimisõna	B2
hümn	nimisõna	B2
hüpe	nimisõna	B2
hüpoteek	nimisõna	B2
hüpotees	nimisõna	B2
hüppenöör	nimisõna	B2
hüsteeria	nimisõna	B2
hüvang	nimisõna	B2
hüve	nimisõna	B2
hüvitama	tegusõna	B2
hüvitis	nimisõna	B2
hüvitus	nimisõna	B2
hüüatama	tegusõna	B2
hüüdnimi	nimisõna	B2
hüüe	nimisõna	B2
idamaine	omadussõna	B2
ideaal	nimisõna	B2
ideaalne	omadussõna	B2
ideaalselt	määrsõna	B2
identifitseerima	tegusõna	B2
identiteet	nimisõna	B2
identne	omadussõna	B2
ideoloogia	nimisõna	B2
ideoloogiline	omadussõna	B2
idioot	nimisõna	B2
igakuine	omadussõna	B2
igakülgne	omadussõna	B2
iganes	määrsõna	B2
igapäevaselt	määrsõna	B2
igatahes	määrsõna	B2
igatsus	nimisõna	B2
igavene	omadussõna	B2
igaveseks	määrsõna	B2
igavesti	määrsõna	B2
igavik	nimisõna	B2
igavlema	tegusõna	B2
igavus	nimisõna	B2
ige	nimisõna	B2
ignoreerima	tegusõna	B2
ihukaitsja	nimisõna	B2
iidne	omadussõna	B2
iidol	nimisõna	B2
iiveldus	nimisõna	B2
ikoon	nimisõna	B2
illegaalne	omadussõna	B2
illusioon	nimisõna	B2
illustratsioon	nimisõna	B2
illustreerima	tegusõna	B2
ilmajaam	nimisõna	B2
ilmalik	omadussõna	B2
ilmastik	nimisõna	B2
ilmastikutingimused	nimisõna	B2
ilme	nimisõna	B2
ilmekalt	määrsõna	B2
ilmekas	omadussõna	B2
ilmestama	tegusõna	B2
ilming	nimisõna	B2
ilmnema	tegusõna	B2
ilmselge	omadussõna	B2
ilmselgelt	määrsõna	B2
ilmtingimata	määrsõna	B2
ilukirjandus	nimisõna	B2
ilutsema	tegusõna	B2
iluuisutamine	nimisõna	B2
iluvõimlemine	nimisõna	B2
imago	nimisõna	B2
imama	tegusõna	B2
imbuma	tegusõna	B2
imeilus	omadussõna	B2
imekaunis	omadussõna	B2
imekombel	määrsõna	B2
imeline	omadussõna	B2
imeliselt	määrsõna	B2
imenduma	tegusõna	B2
imepärane	omadussõna	B2
imestama	tegusõna	B2
imestus	nimisõna	B2
imetaja	nimisõna	B2
imetama	tegusõna	B2
imetlus	nimisõna	B2
imik	nimisõna	B2
imiteerima	tegusõna	B2
immigrant	nimisõna	B2
immigratsioon	nimisõna	B2
immuunsus	nimisõna	B2
impeerium	nimisõna	B2
implantaat	nimisõna	B2
import	nimisõna	B2
importima	tegusõna	B2
improvisatsioon	nimisõna	B2
improviseerima	tegusõna	B2
impulss	nimisõna	B2
ind	nimisõna	B2
indeks	nimisõna	B2
indikaator	nimisõna	B2
indiviid	nimisõna	B2
infarkt	nimisõna	B2
infektsioon	nimisõna	B2
inflatsioon	nimisõna	B2
informatiivne	omadussõna	B2
informeeritus	nimisõna	B2
infrastruktuur	nimisõna	B2
ingver	nimisõna	B2
inimkond	nimisõna	B2
inimlikkus	nimisõna	B2
inimolend	nimisõna	B2
inimõigus	nimisõna	B2
initsiatiiv	nimisõna	B2
innovaatiline	omadussõna	B2
innovatiivne	omadussõna	B2
innovatsioon	nimisõna	B2
innustama	tegusõna	B2
innustus	nimisõna	B2
inspektor	nimisõna	B2
inspektsioon	nimisõna	B2
inspiratsioon	nimisõna	B2
inspireerima	tegusõna	B2
installatsioon	nimisõna	B2
installeerima	tegusõna	B2
installima	tegusõna	B2
instinkt	nimisõna	B2
institutsioon	nimisõna	B2
instruktor	nimisõna	B2
instruktsioon	nimisõna	B2
instrument	nimisõna	B2
insuliin	nimisõna	B2
insult	nimisõna	B2
integratsioon	nimisõna	B2
integreerima	tegusõna	B2
integreeruma	tegusõna	B2
intellekt	nimisõna	B2
intellektuaal	nimisõna	B2
intellektuaalne	omadussõna	B2
intelligentne	omadussõna	B2
intelligents	nimisõna	B2
intelligentsus	nimisõna	B2
intensiivistama	tegusõna	B2
intensiivistuma	tegusõna	B2
intensiivne	omadussõna	B2
intensiivselt	määrsõna	B2
intensiivsus	nimisõna	B2
interaktiivne	omadussõna	B2
interjöör	nimisõna	B2
intervall	nimisõna	B2
intervjueerima	tegusõna	B2
intiimne	omadussõna	B2
intriig	nimisõna	B2
intsident	nimisõna	B2
intuitiivne	omadussõna	B2
intuitsioon	nimisõna	B2
inventuur	nimisõna	B2
investeerima	tegusõna	B2
investeering	nimisõna	B2
investor	nimisõna	B2
iroonia	nimisõna	B2
irooniline	omadussõna	B2
isamaa	nimisõna	B2
isamaaline	omadussõna	B2
isand	nimisõna	B2
isapuhkus	nimisõna	B2
iseasi	nimisõna	B2
iseenesestmõistetav	omadussõna	B2
isekas	omadussõna	B2
iseloomustus	nimisõna	B2
isemoodi	määrsõna	B2
isetegevus	nimisõna	B2
iseärasus	nimisõna	B2
isikuandmed	nimisõna	B2
isikupära	nimisõna	B2
islam	nimisõna	B2
isolatsioon	nimisõna	B2
isoleerima	tegusõna	B2
issand	nimisõna	B2
istung	nimisõna	B2
istutama	tegusõna	B2
isuäratav	omadussõna	B2
iva	nimisõna	B2
jaanalind	nimisõna	B2
jaatav	omadussõna	B2
jabur	omadussõna	B2
jaburus	nimisõna	B2
jada	nimisõna	B2
jaemüük	nimisõna	B2
jagu	nimisõna	B2
jagu saama	tegusõna	B2
jahtima	tegusõna	B2
jahtuma	tegusõna	B2
jahutama	tegusõna	B2
jahutus	nimisõna	B2
jahvatama	tegusõna	B2
jaks	nimisõna	B2
jalutuskäik	nimisõna	B2
jama	nimisõna	B2
jamama	tegusõna	B2
jaotuma	tegusõna	B2
jaotus	nimisõna	B2
jonn	nimisõna	B2
jonnima	tegusõna	B2
jood	nimisõna	B2
jooga	nimisõna	B2
jooksev	omadussõna	B2
jooksutama	tegusõna	B2
joonis	nimisõna	B2
jootma	tegusõna	B2
joove	nimisõna	B2
jube	määrsõna	B2
jubedalt	määrsõna	B2
judo	nimisõna	B2
juga	nimisõna	B2
juhendama	tegusõna	B2
juhinduma	tegusõna	B2
juhis	nimisõna	B2
juhitavus	nimisõna	B2
juhtkiri	nimisõna	B2
juhtmevaba	omadussõna	B2
juhtnöör	nimisõna	B2
juhtum	nimisõna	B2
juhuslikult	määrsõna	B2
julgeolek	nimisõna	B2
julgeolekupoliitika	nimisõna	B2
julgustama	tegusõna	B2
julgustav	omadussõna	B2
julm	omadussõna	B2
julmalt	määrsõna	B2
julmus	nimisõna	B2
jumalaga	hüüdsõna	B2
jumaldama	tegusõna	B2
jumalik	omadussõna	B2
jume	nimisõna	B2
jumestaja	nimisõna	B2
jumestus	nimisõna	B2
jupp	nimisõna	B2
justnagu	määrsõna	B2
justnimelt	määrsõna	B2
jutlustama	tegusõna	B2
jutustus	nimisõna	B2
jututuba	nimisõna	B2
juubilar	nimisõna	B2
juunior	nimisõna	B2
juur	nimisõna	B2
juurdepääs	nimisõna	B2
juurdlus	nimisõna	B2
juuresolek	nimisõna	B2
juurikas	nimisõna	B2
jõehobu	nimisõna	B2
jõhker	omadussõna	B2
jõhkralt	määrsõna	B2
jõhkrus	nimisõna	B2
jõudlus	nimisõna	B2
jõudumööda	määrsõna	B2
jõuetu	omadussõna	B2
jõuk	nimisõna	B2
jõukas	omadussõna	B2
jõukohane	omadussõna	B2
jõukus	nimisõna	B2
jõul	kaassõna	B2
jõuline	omadussõna	B2
jõuliselt	määrsõna	B2
jõululaupäev	nimisõna	B2
jõustuma	tegusõna	B2
jäik	omadussõna	B2
jäine	omadussõna	B2
jälitama	tegusõna	B2
jällegi	määrsõna	B2
jäme	omadussõna	B2
järeldama	tegusõna	B2
järelduma	tegusõna	B2
järele andma	tegusõna	B2
järelkasv	nimisõna	B2
järelt	kaassõna	B2
järeltulija	nimisõna	B2
järeltöö	nimisõna	B2
järelvalve	nimisõna	B2
järg	nimisõna	B2
järgne	omadussõna	B2
järgnevalt	määrsõna	B2
järjekindel	omadussõna	B2
järjekindlalt	määrsõna	B2
järjekindlus	nimisõna	B2
järjekordselt	määrsõna	B2
järjepidev	omadussõna	B2
järjepidevalt	määrsõna	B2
järjepidevus	nimisõna	B2
järjestama	tegusõna	B2
järjestikune	omadussõna	B2
järjestus	nimisõna	B2
järk	nimisõna	B2
järk-järgult	määrsõna	B2
järkjärguline	omadussõna	B2
järsult	määrsõna	B2
jätk	nimisõna	B2
jätkusuutlik	omadussõna	B2
jätkusuutlikkus	nimisõna	B2
jätkuv	omadussõna	B2
jäädvustama	tegusõna	B2
jäähoki	nimisõna	B2
jääk	nimisõna	B2
jääkülm	omadussõna	B2
jäänus	nimisõna	B2
jäär	nimisõna	B2
jääsalat	nimisõna	B2
jäätmed	nimisõna	B2
jäätmejaam	nimisõna	B2
jäätuma	tegusõna	B2
jünger	nimisõna	B2
kaabakas	nimisõna	B2
kaabel	nimisõna	B2
kaader	nimisõna	B2
kaalujälgija	nimisõna	B2
kaalukas	omadussõna	B2
kaalutlema	tegusõna	B2
kaalutlus	nimisõna	B2
kaamel	nimisõna	B2
kaar	nimisõna	B2
kaardistama	tegusõna	B2
kaasa haarama	tegusõna	B2
kaasabi	nimisõna	B2
kaasaeg	nimisõna	B2
kaasahaarav	omadussõna	B2
kaasama	tegusõna	B2
kaasmaalane	nimisõna	B2
kaasnema	tegusõna	B2
kaasomand	nimisõna	B2
kaastundlik	omadussõna	B2
kaastöö	nimisõna	B2
kabel	nimisõna	B2
kabiin	nimisõna	B2
kadakas	nimisõna	B2
kade	omadussõna	B2
kadedus	nimisõna	B2
kadestama	tegusõna	B2
kadu	nimisõna	B2
kadunu	nimisõna	B2
kaebus	nimisõna	B2
kaelkirjak	nimisõna	B2
kaenal	nimisõna	B2
kaevandama	tegusõna	B2
kaevandus	nimisõna	B2
kaevur	nimisõna	B2
kahandama	tegusõna	B2
kahanema	tegusõna	B2
kahekordistama	tegusõna	B2
kahekordistuma	tegusõna	B2
kahene	omadussõna	B2
kahepoolne	omadussõna	B2
kahetsus	nimisõna	B2
kahetsusväärne	omadussõna	B2
kahevahel	määrsõna	B2
kahjustuma	tegusõna	B2
kahjustus	nimisõna	B2
kahjutu	omadussõna	B2
kahtlemata	määrsõna	B2
kahtlustus	nimisõna	B2
kahur	nimisõna	B2
kahvatu	omadussõna	B2
kai	nimisõna	B2
kaitseala	nimisõna	B2
kaitsejõud	nimisõna	B2
kaitseliit	nimisõna	B2
kaitsetu	omadussõna	B2
kaitsevahend	nimisõna	B2
kaitseväelane	nimisõna	B2
kaja	nimisõna	B2
kajama	tegusõna	B2
kajastama	tegusõna	B2
kajastuma	tegusõna	B2
kajastus	nimisõna	B2
kaklus	nimisõna	B2
kalandus	nimisõna	B2
kalduma	tegusõna	B2
kalduvus	nimisõna	B2
kalendriaasta	nimisõna	B2
kalju	nimisõna	B2
kalkulatsioon	nimisõna	B2
kallak	nimisõna	B2
kallal	kaassõna	B2
kallaletung	nimisõna	B2
kallama	tegusõna	B2
kalle	nimisõna	B2
kallim	nimisõna	B2
kallinema	tegusõna	B2
kallistus	nimisõna	B2
kalor	nimisõna	B2
kamber	nimisõna	B2
kamp	nimisõna	B2
kandidatuur	nimisõna	B2
kanduma	tegusõna	B2
kaneel	nimisõna	B2
kanep	nimisõna	B2
kang	nimisõna	B2
kangas	nimisõna	B2
kangekaelne	omadussõna	B2
kangesti	määrsõna	B2
kangutama	tegusõna	B2
kannatamatu	omadussõna	B2
kannatlik	omadussõna	B2
kannatlikkus	nimisõna	B2
kannike	nimisõna	B2
kant	nimisõna	B2
kantsler	nimisõna	B2
kanuu	nimisõna	B2
kaootiline	omadussõna	B2
kaos	nimisõna	B2
kaotsi	määrsõna	B2
kapital	nimisõna	B2
kapitalism	nimisõna	B2
kapitalistlik	omadussõna	B2
kapott	nimisõna	B2
kapsel	nimisõna	B2
karakter	nimisõna	B2
karastama	tegusõna	B2
karastusjook	nimisõna	B2
karbonaad	nimisõna	B2
kardetavasti	määrsõna	B2
kardinaalne	omadussõna	B2
kardinaalselt	määrsõna	B2
kardinal	nimisõna	B2
kare	omadussõna	B2
kari	nimisõna	B2
karikatuur	nimisõna	B2
karjatama	tegusõna	B2
karjäär	nimisõna	B2
karm	omadussõna	B2
karmilt	määrsõna	B2
karneval	nimisõna	B2
kartlik	omadussõna	B2
kartmatu	omadussõna	B2
kartus	nimisõna	B2
karusnahk	nimisõna	B2
karussell	nimisõna	B2
kasiino	nimisõna	B2
kaste	nimisõna	B2
kasuema	nimisõna	B2
kasuisa	nimisõna	B2
kasulikkus	nimisõna	B2
kasum	nimisõna	B2
kasutajaliides	nimisõna	B2
kasutu	omadussõna	B2
kasutuselevõtt	nimisõna	B2
kasutusluba	nimisõna	B2
kasutusõigus	nimisõna	B2
kasvaja	nimisõna	B2
kasvõi	määrsõna	B2
kataloog	nimisõna	B2
katedraal	nimisõna	B2
kategooria	nimisõna	B2
kategooriliselt	määrsõna	B2
katel	nimisõna	B2
katk	nimisõna	B2
katkematu	omadussõna	B2
katkend	nimisõna	B2
katkestus	nimisõna	B2
katlakivi	nimisõna	B2
katseaeg	nimisõna	B2
katsumus	nimisõna	B2
kattuma	tegusõna	B2
kauaaegne	omadussõna	B2
kaubamärk	nimisõna	B2
kaubandus	nimisõna	B2
kaubanduslik	omadussõna	B2
kaubik	nimisõna	B2
kaudne	omadussõna	B2
kaudselt	määrsõna	B2
kaugeltki	määrsõna	B2
kaugenema	tegusõna	B2
kaugushüpe	nimisõna	B2
kaugõpe	nimisõna	B2
kaun	nimisõna	B2
kaunilt	määrsõna	B2
kaunis	määrsõna	B2
kaunistus	nimisõna	B2
kaunitar	nimisõna	B2
kaupa	kaassõna	B2
kaupleja	nimisõna	B2
kaupmees	nimisõna	B2
kaust	nimisõna	B2
kaustik	nimisõna	B2
kavaldama	tegusõna	B2
kavalpea	nimisõna	B2
kavalus	nimisõna	B2
kavand	nimisõna	B2
kavatsus	nimisõna	B2
keedis	nimisõna	B2
keelebarjäär	nimisõna	B2
keeleteadlane	nimisõna	B2
keelustama	tegusõna	B2
keemiarelv	nimisõna	B2
keeris	nimisõna	B2
keerukas	omadussõna	B2
keerukus	nimisõna	B2
keerutama	tegusõna	B2
keevitaja	nimisõna	B2
keevitama	tegusõna	B2
kehakaal	nimisõna	B2
kehakeel	nimisõna	B2
kehastama	tegusõna	B2
kehastuma	tegusõna	B2
kehtestama	tegusõna	B2
kehtetu	omadussõna	B2
kehtivus	nimisõna	B2
kehtivusaeg	nimisõna	B2
keiser	nimisõna	B2
kelgutama	tegusõna	B2
kelk	nimisõna	B2
kemikaal	nimisõna	B2
keraamika	nimisõna	B2
keraamiline	omadussõna	B2
kere	nimisõna	B2
kergemeelne	omadussõna	B2
kergemini	määrsõna	B2
kergendama	tegusõna	B2
kergendus	nimisõna	B2
kergitama	tegusõna	B2
kergus	nimisõna	B2
kerjus	nimisõna	B2
kerkima	tegusõna	B2
kesk	kaassõna	B2
keskaeg	nimisõna	B2
keskelt	määrsõna	B2
keskne	omadussõna	B2
keskpärane	omadussõna	B2
kest	nimisõna	B2
kestel	kaassõna	B2
kestus	nimisõna	B2
kestvus	nimisõna	B2
ketas	nimisõna	B2
kibestuma	tegusõna	B2
kihelkond	nimisõna	B2
kihluma	tegusõna	B2
kihlus	nimisõna	B2
kihlvedu	nimisõna	B2
kiht	nimisõna	B2
kihutama	tegusõna	B2
kihvt	omadussõna	B2
kiil	nimisõna	B2
kiinduma	tegusõna	B2
kiip	nimisõna	B2
kiir	nimisõna	B2
kiireloomuline	omadussõna	B2
kiirendus	nimisõna	B2
kiirenema	tegusõna	B2
kiirgama	tegusõna	B2
kiirgus	nimisõna	B2
kiirtoit	nimisõna	B2
kiitlema	tegusõna	B2
kikkis	omadussõna	B2
kild	nimisõna	B2
kilp	nimisõna	B2
kimalane	nimisõna	B2
kindlameelne	omadussõna	B2
kindlustunne	nimisõna	B2
kindlustusmakse	nimisõna	B2
kinni hoidma	tegusõna	B2
kinni pidama	tegusõna	B2
kinni võtma	tegusõna	B2
kinnisidee	nimisõna	B2
kinnistama	tegusõna	B2
kinnistu	nimisõna	B2
kinnistuma	tegusõna	B2
kinnituma	tegusõna	B2
kippuma	tegusõna	B2
kips	nimisõna	B2
kirglik	omadussõna	B2
kirglikult	määrsõna	B2
kiriklik	omadussõna	B2
kirjakeel	nimisõna	B2
kirjand	nimisõna	B2
kirjanduslik	omadussõna	B2
kirjaoskus	nimisõna	B2
kirjastama	tegusõna	B2
kirjatäht	nimisõna	B2
kirje	nimisõna	B2
kirjeldus	nimisõna	B2
kirp	nimisõna	B2
kisama	tegusõna	B2
kiskuma	tegusõna	B2
kitsaskoht	nimisõna	B2
kitsendama	tegusõna	B2
kittel	nimisõna	B2
kiusatus	nimisõna	B2
kivim	nimisõna	B2
klamber	nimisõna	B2
klammerdaja	nimisõna	B2
klapp	nimisõna	B2
klappima	tegusõna	B2
klassifikatsioon	nimisõna	B2
klassifitseerima	tegusõna	B2
klassik	nimisõna	B2
kleebis	nimisõna	B2
kleeps	nimisõna	B2
kleepuma	tegusõna	B2
klienditeenindus	nimisõna	B2
klientuur	nimisõna	B2
kliiniline	omadussõna	B2
klikk	nimisõna	B2
klipp	nimisõna	B2
kloonima	tegusõna	B2
klooster	nimisõna	B2
kloppima	tegusõna	B2
klots	nimisõna	B2
klõpsama	tegusõna	B2
koalitsioon	nimisõna	B2
kobras	nimisõna	B2
koda	nimisõna	B2
kodanikupäev	nimisõna	B2
kodanlik	omadussõna	B2
kodeerima	tegusõna	B2
kodukontor	nimisõna	B2
kodukord	nimisõna	B2
kofeiin	nimisõna	B2
kogelema	tegusõna	B2
kogenematu	omadussõna	B2
kogudus	nimisõna	B2
kogukond	nimisõna	B2
kogum	nimisõna	B2
kogumik	nimisõna	B2
koguni	määrsõna	B2
kogunisti	määrsõna	B2
kohaldama	tegusõna	B2
kohandama	tegusõna	B2
kohanduma	tegusõna	B2
kohane	omadussõna	B2
kohanimi	nimisõna	B2
kohapealne	omadussõna	B2
kohaselt	määrsõna	B2
kohastuma	tegusõna	B2
kohendama	tegusõna	B2
kohene	omadussõna	B2
koheselt	määrsõna	B2
kohmakas	omadussõna	B2
kohting	nimisõna	B2
kohtlema	tegusõna	B2
kohtutäitur	nimisõna	B2
kohusetruu	omadussõna	B2
kohusetundlik	omadussõna	B2
kohusetunne	nimisõna	B2
kohusetäitja	nimisõna	B2
kohustama	tegusõna	B2
kohustuma	tegusõna	B2
kohutavalt	määrsõna	B2
koit	nimisõna	B2
koitma	tegusõna	B2
kojamees	nimisõna	B2
kokaiin	nimisõna	B2
kokkuhoid	nimisõna	B2
kokkuhoidlik	omadussõna	B2
kokkupandav	omadussõna	B2
kokkupuude	nimisõna	B2
kokkupõrge	nimisõna	B2
kokkusattumus	nimisõna	B2
kokkuvõtvalt	määrsõna	B2
kola	nimisõna	B2
kolb	nimisõna	B2
kole	määrsõna	B2
kolesterool	nimisõna	B2
koletis	nimisõna	B2
kolin	nimisõna	B2
koll	nimisõna	B2
kolle	nimisõna	B2
kolleegium	nimisõna	B2
kollektiiv	nimisõna	B2
kollektiivne	omadussõna	B2
kolmik	nimisõna	B2
kolonel	nimisõna	B2
kolonn	nimisõna	B2
koloonia	nimisõna	B2
komandeering	nimisõna	B2
komando	nimisõna	B2
kombel	kaassõna	B2
kombinaat	nimisõna	B2
kombinatsioon	nimisõna	B2
kombineerima	tegusõna	B2
komeet	nimisõna	B2
komistama	tegusõna	B2
kommunikatsioon	nimisõna	B2
kompaktne	omadussõna	B2
kompass	nimisõna	B2
kompensatsioon	nimisõna	B2
kompenseerima	tegusõna	B2
kompetentne	omadussõna	B2
kompetents	nimisõna	B2
kompetentsus	nimisõna	B2
kompleks	nimisõna	B2
komplekteerima	tegusõna	B2
kompliment	nimisõna	B2
komponent	nimisõna	B2
konditsioneer	nimisõna	B2
konfidentsiaalne	omadussõna	B2
konfiskeerima	tegusõna	B2
konfliktne	omadussõna	B2
kong	nimisõna	B2
konkreetselt	määrsõna	B2
konkureerima	tegusõna	B2
konkurent	nimisõna	B2
konkurentsivõime	nimisõna	B2
konkurentsivõimeline	omadussõna	B2
konsensus	nimisõna	B2
konservatiivne	omadussõna	B2
konservatoorium	nimisõna	B2
konspekt	nimisõna	B2
konstaabel	nimisõna	B2
konstitutsioon	nimisõna	B2
konstrueerima	tegusõna	B2
konstruktiivne	omadussõna	B2
konsul	nimisõna	B2
konsulaat	nimisõna	B2
konsulteerima	tegusõna	B2
kont	nimisõna	B2
kontakteeruma	tegusõna	B2
kontaktisik	nimisõna	B2
konteiner	nimisõna	B2
kontinent	nimisõna	B2
kontingent	nimisõna	B2
kontrast	nimisõna	B2
kontrastne	omadussõna	B2
kontrollimatu	omadussõna	B2
kontsentratsioon	nimisõna	B2
kontsentreerima	tegusõna	B2
kontsentreeruma	tegusõna	B2
kontseptsioon	nimisõna	B2
kontseptuaalne	omadussõna	B2
kontsern	nimisõna	B2
konventsioon	nimisõna	B2
koobas	nimisõna	B2
koodeks	nimisõna	B2
kool	nimisõna	B2
koolitaja	nimisõna	B2
koolitama	tegusõna	B2
koolkond	nimisõna	B2
kooma	nimisõna	B2
koomik	nimisõna	B2
koomiks	nimisõna	B2
koomiline	omadussõna	B2
koonduma	tegusõna	B2
koordinaat	nimisõna	B2
koordinaator	nimisõna	B2
koordineerima	tegusõna	B2
koorem	nimisõna	B2
koorima	tegusõna	B2
koormama	tegusõna	B2
kooruma	tegusõna	B2
kooselu	nimisõna	B2
kooskõla	nimisõna	B2
kooskõlastama	tegusõna	B2
kooslus	nimisõna	B2
koostisosa	nimisõna	B2
kopeerima	tegusõna	B2
kopp	nimisõna	B2
koppel	nimisõna	B2
kopter	nimisõna	B2
korda minema	tegusõna	B2
kordaminek	nimisõna	B2
kordamööda	määrsõna	B2
kordumatu	omadussõna	B2
kordus	nimisõna	B2
koreograaf	nimisõna	B2
korgitser	nimisõna	B2
korporatsioon	nimisõna	B2
korralagedus	nimisõna	B2
korraldus	nimisõna	B2
korraline	omadussõna	B2
korrapärane	omadussõna	B2
korrapäraselt	määrsõna	B2
korrastama	tegusõna	B2
korratu	omadussõna	B2
korrektsus	nimisõna	B2
korrelatsioon	nimisõna	B2
korrespondent	nimisõna	B2
korrigeerima	tegusõna	B2
korrumpeeruma	tegusõna	B2
korterelamu	nimisõna	B2
kortsus	omadussõna	B2
kortsutama	tegusõna	B2
kosk	nimisõna	B2
kosmeetika	nimisõna	B2
kosmiline	omadussõna	B2
kosmonaut	nimisõna	B2
kostma	tegusõna	B2
kostuma	tegusõna	B2
kraadine	omadussõna	B2
kraam	nimisõna	B2
kraana	nimisõna	B2
kraapima	tegusõna	B2
kraater	nimisõna	B2
kraav	nimisõna	B2
krae	nimisõna	B2
krahh	nimisõna	B2
krahv	nimisõna	B2
kramp	nimisõna	B2
kratsima	tegusõna	B2
kratt	nimisõna	B2
krediit	nimisõna	B2
krediitkaart	nimisõna	B2
kriimustama	tegusõna	B2
kriimustus	nimisõna	B2
kriips	nimisõna	B2
kriisiolukord	nimisõna	B2
kriit	nimisõna	B2
kriminaal	nimisõna	B2
kriminaalne	omadussõna	B2
kristall	nimisõna	B2
kristlus	nimisõna	B2
kriteerium	nimisõna	B2
krookus	nimisõna	B2
kroonima	tegusõna	B2
kross	nimisõna	B2
kruus	nimisõna	B2
krõbe	omadussõna	B2
kubu	nimisõna	B2
kudum	nimisõna	B2
kuhi	nimisõna	B2
kuhjuma	tegusõna	B2
kuidagi	määrsõna	B2
kuigivõrd	määrsõna	B2
kuivus	nimisõna	B2
kuivõrd	määrsõna	B2
kujund	nimisõna	B2
kujundlik	omadussõna	B2
kujundus	nimisõna	B2
kujutis	nimisõna	B2
kujutlema	tegusõna	B2
kujutlus	nimisõna	B2
kujutlusvõime	nimisõna	B2
kukkel	nimisõna	B2
kukutama	tegusõna	B2
kuldnokk	nimisõna	B2
kulgema	tegusõna	B2
kull	nimisõna	B2
kullerkupp	nimisõna	B2
kulminatsioon	nimisõna	B2
kulmineeruma	tegusõna	B2
kultus	nimisõna	B2
kulukas	omadussõna	B2
kulunud	omadussõna	B2
kulutus	nimisõna	B2
kumer	omadussõna	B2
kummardama	tegusõna	B2
kummarduma	tegusõna	B2
kummardus	nimisõna	B2
kummitama	tegusõna	B2
kummitus	nimisõna	B2
kummut	nimisõna	B2
kuniks	määrsõna	B2
kuninglik	omadussõna	B2
kuningriik	nimisõna	B2
kunstiline	omadussõna	B2
kunstiteos	nimisõna	B2
kunstnahk	nimisõna	B2
kupee	nimisõna	B2
kuraator	nimisõna	B2
kurikuulus	omadussõna	B2
kuristik	nimisõna	B2
kuritarvitama	tegusõna	B2
kuritegelik	omadussõna	B2
kurjus	nimisõna	B2
kurnav	omadussõna	B2
kurvameelne	omadussõna	B2
kurvastama	tegusõna	B2
kurvastus	nimisõna	B2
kusjuures	määrsõna	B2
kuskilt	määrsõna	B2
kustuma	tegusõna	B2
kutseeksam	nimisõna	B2
kutsetunnistus	nimisõna	B2
kutt	nimisõna	B2
kuub	nimisõna	B2
kuulajaskond	nimisõna	B2
kuuldus	nimisõna	B2
kuulekas	omadussõna	B2
kuuletuma	tegusõna	B2
kuulipilduja	nimisõna	B2
kuulitõuge	nimisõna	B2
kuulujutt	nimisõna	B2
kuuluvus	nimisõna	B2
kuumalaine	nimisõna	B2
kuumarabandus	nimisõna	B2
kuumenema	tegusõna	B2
kuumus	nimisõna	B2
kuumutama	tegusõna	B2
kuup	nimisõna	B2
kuupmeeter	nimisõna	B2
kuur	nimisõna	B2
kuurort	nimisõna	B2
kuuseriisikas	nimisõna	B2
kuvama	tegusõna	B2
kuvand	nimisõna	B2
kvalifikatsioon	nimisõna	B2
kvalifitseerima	tegusõna	B2
kvalifitseeruma	tegusõna	B2
kvalitatiivne	omadussõna	B2
kvantitatiivne	omadussõna	B2
kvartett	nimisõna	B2
kvoot	nimisõna	B2
kõhklema	tegusõna	B2
kõhklus	nimisõna	B2
kõhukinnisus	nimisõna	B2
kõhulahtisus	nimisõna	B2
kõhulihas	nimisõna	B2
kõigest	määrsõna	B2
kõigutama	tegusõna	B2
kõikjale	määrsõna	B2
kõikjalt	määrsõna	B2
kõikuma	tegusõna	B2
kõikvõimas	omadussõna	B2
kõla	nimisõna	B2
kõlblik	omadussõna	B2
kõlbmatu	omadussõna	B2
kõnekas	omadussõna	B2
kõnepruuk	nimisõna	B2
kõnepult	nimisõna	B2
kõnetama	tegusõna	B2
kõrbema	tegusõna	B2
kõrgemal	määrsõna	B2
kõrgemale	määrsõna	B2
kõrgendama	tegusõna	B2
kõrgenema	tegusõna	B2
kõrgetasemeline	omadussõna	B2
kõrgrõhkkond	nimisõna	B2
kõrgtehnoloogiline	omadussõna	B2
kõrguma	tegusõna	B2
kõrgushüpe	nimisõna	B2
kõri	nimisõna	B2
kõrkjas	nimisõna	B2
kõrs	nimisõna	B2
kõrts	nimisõna	B2
kõrvaldama	tegusõna	B2
kõrvaline	omadussõna	B2
kõrvalmõju	nimisõna	B2
kõrvalseisja	nimisõna	B2
kõrvaltoime	nimisõna	B2
kõrvaltvaataja	nimisõna	B2
kõrvarõngas	nimisõna	B2
kõrvatropp	nimisõna	B2
kõrvetama	tegusõna	B2
kõrvutama	tegusõna	B2
kõu	nimisõna	B2
kõvaketas	nimisõna	B2
käekäik	nimisõna	B2
käepärane	omadussõna	B2
käepärast	määrsõna	B2
käevõru	nimisõna	B2
kägistama	tegusõna	B2
kägu	nimisõna	B2
kähku	määrsõna	B2
kährik	nimisõna	B2
käigus	kaassõna	B2
käimasolev	omadussõna	B2
käive	nimisõna	B2
käivitama	tegusõna	B2
käivituma	tegusõna	B2
känd	nimisõna	B2
känguru	nimisõna	B2
kännuseen	nimisõna	B2
käpik	nimisõna	B2
kärbe	nimisõna	B2
kärbseseen	nimisõna	B2
kärnkonn	nimisõna	B2
kärpima	tegusõna	B2
käru	nimisõna	B2
käsikiri	nimisõna	B2
käsikäes	määrsõna	B2
käsil	määrsõna	B2
käsimüük	nimisõna	B2
käsipall	nimisõna	B2
käsiraamat	nimisõna	B2
käsitama	tegusõna	B2
käsitlema	tegusõna	B2
käsitlus	nimisõna	B2
käsitööline	nimisõna	B2
käskkiri	nimisõna	B2
käsutama	tegusõna	B2
käsutus	nimisõna	B2
kättemaks	nimisõna	B2
kättesaadavus	nimisõna	B2
kättesaamatu	omadussõna	B2
käänama	tegusõna	B2
kääne	nimisõna	B2
käärima	tegusõna	B2
köhima	tegusõna	B2
köide	nimisõna	B2
köis	nimisõna	B2
köitma	tegusõna	B2
köömen	nimisõna	B2
kükitama	tegusõna	B2
külalistemaja	nimisõna	B2
külastatavus	nimisõna	B2
külastus	nimisõna	B2
külili	määrsõna	B2
küllap	määrsõna	B2
külmalaine	nimisõna	B2
külmetus	nimisõna	B2
külmetushaigus	nimisõna	B2
külmuma	tegusõna	B2
külmutama	tegusõna	B2
külvama	tegusõna	B2
kümnend	nimisõna	B2
küngas	nimisõna	B2
küps	omadussõna	B2
küpsetis	nimisõna	B2
küpsetuspulber	nimisõna	B2
küpsus	nimisõna	B2
küsimustik	nimisõna	B2
küsitav	omadussõna	B2
küsitavus	nimisõna	B2
küsitlema	tegusõna	B2
kütkestav	omadussõna	B2
kütt	nimisõna	B2
küttepuu	nimisõna	B2
küüditama	tegusõna	B2
küün	nimisõna	B2
laama	nimisõna	B2
laat	nimisõna	B2
labane	omadussõna	B2
labor	nimisõna	B2
laboratoorium	nimisõna	B2
labürint	nimisõna	B2
laduma	tegusõna	B2
ladus	omadussõna	B2
ladustama	tegusõna	B2
laekuma	tegusõna	B2
laeng	nimisõna	B2
lage	omadussõna	B2
lahend	nimisõna	B2
lahenema	tegusõna	B2
lahjendama	tegusõna	B2
lahkama	tegusõna	B2
lahkelt	määrsõna	B2
lahkesti	määrsõna	B2
lahkuminek	nimisõna	B2
laht	nimisõna	B2
lahter	nimisõna	B2
lahti laskma	tegusõna	B2
lahti saama	tegusõna	B2
lahus	nimisõna	B2
lahustama	tegusõna	B2
lahustuma	tegusõna	B2
lahutamatu	omadussõna	B2
lahutus	nimisõna	B2
laialdane	omadussõna	B2
laialdaselt	määrsõna	B2
laiali ajama	tegusõna	B2
laiali minema	tegusõna	B2
laiali saatma	tegusõna	B2
laiendus	nimisõna	B2
laienema	tegusõna	B2
laiguline	omadussõna	B2
laik	nimisõna	B2
laim	nimisõna	B2
laimama	tegusõna	B2
laisklema	tegusõna	B2
laiskus	nimisõna	B2
laiskvorst	nimisõna	B2
lakk	nimisõna	B2
lakkama	tegusõna	B2
laks	nimisõna	B2
lame	omadussõna	B2
lammutama	tegusõna	B2
langenu	nimisõna	B2
langevari	nimisõna	B2
langus	nimisõna	B2
lapp	nimisõna	B2
lapsehoolduspuhkus	nimisõna	B2
lapselik	omadussõna	B2
lapsemeelne	omadussõna	B2
lapsendama	tegusõna	B2
laser	nimisõna	B2
lask	nimisõna	B2
laskemoon	nimisõna	B2
lasketiir	nimisõna	B2
laskuma	tegusõna	B2
lastetu	omadussõna	B2
latern	nimisõna	B2
latt	nimisõna	B2
laudlina	nimisõna	B2
laug	nimisõna	B2
lauge	omadussõna	B2
laulatus	nimisõna	B2
laureaat	nimisõna	B2
lausuma	tegusõna	B2
lauvärv	nimisõna	B2
lavastaja	nimisõna	B2
laviin	nimisõna	B2
leebe	omadussõna	B2
leedi	nimisõna	B2
leek	nimisõna	B2
leer	nimisõna	B2
leetrid	nimisõna	B2
leevendama	tegusõna	B2
leevendus	nimisõna	B2
leevike	nimisõna	B2
legaalne	omadussõna	B2
legaliseerima	tegusõna	B2
legendaarne	omadussõna	B2
lehitsema	tegusõna	B2
lehtpuu	nimisõna	B2
lehtsalat	nimisõna	B2
lehvitama	tegusõna	B2
leibkond	nimisõna	B2
leid	nimisõna	B2
leidlik	omadussõna	B2
leidlikkus	nimisõna	B2
leige	omadussõna	B2
leil	nimisõna	B2
leinama	tegusõna	B2
leiutaja	nimisõna	B2
leiutis	nimisõna	B2
leke	nimisõna	B2
lekkima	tegusõna	B2
leksikon	nimisõna	B2
lennukas	omadussõna	B2
lennundus	nimisõna	B2
lennutama	tegusõna	B2
lennuvägi	nimisõna	B2
leopard	nimisõna	B2
leotama	tegusõna	B2
lepe	nimisõna	B2
lepinguline	omadussõna	B2
lepitama	tegusõna	B2
leplik	omadussõna	B2
lepp	nimisõna	B2
lesbi	nimisõna	B2
lest	nimisõna	B2
leviala	nimisõna	B2
levik	nimisõna	B2
libedus	nimisõna	B2
liberaal	nimisõna	B2
liberaalne	omadussõna	B2
libistama	tegusõna	B2
ligemal	määrsõna	B2
ligemale	määrsõna	B2
ligi tõmbama	tegusõna	B2
ligidal	määrsõna	B2
ligidal	kaassõna	B2
ligidale	määrsõna	B2
ligidale	kaassõna	B2
ligidalt	määrsõna	B2
ligidalt	kaassõna	B2
ligikaudne	omadussõna	B2
liginema	tegusõna	B2
ligipääs	nimisõna	B2
lihtsameelne	omadussõna	B2
lihtsus	nimisõna	B2
lihtsustama	tegusõna	B2
lihvima	tegusõna	B2
liialdama	tegusõna	B2
liialdus	nimisõna	B2
liialt	määrsõna	B2
liiane	omadussõna	B2
liides	nimisõna	B2
liiga	nimisõna	B2
liigendama	tegusõna	B2
liiges	nimisõna	B2
liigitama	tegusõna	B2
liigselt	määrsõna	B2
liiklema	tegusõna	B2
liikuvus	nimisõna	B2
liikvel	määrsõna	B2
liikvele	määrsõna	B2
liilia	nimisõna	B2
liisima	tegusõna	B2
liising	nimisõna	B2
liisk	nimisõna	B2
liitlane	nimisõna	B2
liitumisläbirääkimised	nimisõna	B2
liivakast	nimisõna	B2
liivavorm	nimisõna	B2
likvideerima	tegusõna	B2
liköör	nimisõna	B2
lilleline	omadussõna	B2
lillepärg	nimisõna	B2
limaskest	nimisõna	B2
limiit	nimisõna	B2
limpsima	tegusõna	B2
linastuma	tegusõna	B2
linastus	nimisõna	B2
linateos	nimisõna	B2
lindistama	tegusõna	B2
linnuke	nimisõna	B2
linnus	nimisõna	B2
lint	nimisõna	B2
lipik	nimisõna	B2
lipupäev	nimisõna	B2
lisand	nimisõna	B2
lisanduma	tegusõna	B2
list	nimisõna	B2
litsents	nimisõna	B2
litsentseerima	tegusõna	B2
litter	nimisõna	B2
liturgia	nimisõna	B2
liumägi	nimisõna	B2
liustik	nimisõna	B2
liuväli	nimisõna	B2
lobisema	tegusõna	B2
loendama	tegusõna	B2
loetelu	nimisõna	B2
loetlema	tegusõna	B2
logi	nimisõna	B2
logistika	nimisõna	B2
logo	nimisõna	B2
logopeed	nimisõna	B2
lohakalt	määrsõna	B2
lohakas	omadussõna	B2
lohakus	nimisõna	B2
lohe	nimisõna	B2
lohistama	tegusõna	B2
lohk	nimisõna	B2
lohutus	nimisõna	B2
lojaalne	omadussõna	B2
lojaalsus	nimisõna	B2
lokaalne	omadussõna	B2
lokk	nimisõna	B2
loksuma	tegusõna	B2
loksutama	tegusõna	B2
lollitama	tegusõna	B2
lollus	nimisõna	B2
lomp	nimisõna	B2
lonkama	tegusõna	B2
lonks	nimisõna	B2
lonkshaaval	määrsõna	B2
loode	nimisõna	B2
loodushoid	nimisõna	B2
looduskaunis	omadussõna	B2
looduskeskkond	nimisõna	B2
looduslikult	määrsõna	B2
loodusressurss	nimisõna	B2
loodusvara	nimisõna	B2
loogika	nimisõna	B2
looja	nimisõna	B2
loome	nimisõna	B2
loomne	omadussõna	B2
loomus	nimisõna	B2
loopima	tegusõna	B2
loorber	nimisõna	B2
loos	nimisõna	B2
loosima	tegusõna	B2
lootusetult	määrsõna	B2
lootusrikas	omadussõna	B2
lootustandev	omadussõna	B2
loov	omadussõna	B2
loovus	nimisõna	B2
loovutama	tegusõna	B2
loputama	tegusõna	B2
lubamatu	omadussõna	B2
lubjakivi	nimisõna	B2
lugematu	omadussõna	B2
lugupeetav	omadussõna	B2
luksus	nimisõna	B2
luksuslik	omadussõna	B2
lukustama	tegusõna	B2
lumehang	nimisõna	B2
lumehelves	nimisõna	B2
lumelaud	nimisõna	B2
lumememm	nimisõna	B2
lumesadu	nimisõna	B2
lumesõda	nimisõna	B2
lumetorm	nimisõna	B2
lunastama	tegusõna	B2
lunastus	nimisõna	B2
lutikas	nimisõna	B2
lutt	nimisõna	B2
luud	nimisõna	B2
luuk	nimisõna	B2
luule	nimisõna	B2
luuletama	tegusõna	B2
luumurd	nimisõna	B2
luup	nimisõna	B2
luurama	tegusõna	B2
luure	nimisõna	B2
luuser	nimisõna	B2
lõbu	nimisõna	B2
lõbunaine	nimisõna	B2
lõbustama	tegusõna	B2
lõbutsema	tegusõna	B2
lõdvestama	tegusõna	B2
lõdvestuma	tegusõna	B2
lõdvestus	nimisõna	B2
lõhe	nimisõna	B2
lõhestama	tegusõna	B2
lõhkeaine	nimisõna	B2
lõhkekeha	nimisõna	B2
lõhkema	tegusõna	B2
lõik	nimisõna	B2
lõikuma	tegusõna	B2
lõiv	nimisõna	B2
lõke	nimisõna	B2
lõks	nimisõna	B2
lõng	nimisõna	B2
lõoke	nimisõna	B2
lõpetus	nimisõna	B2
lõpmatus	nimisõna	B2
lõppsõna	nimisõna	B2
lõpupoole	määrsõna	B2
lõputu	omadussõna	B2
lõputult	määrsõna	B2
lõputunnistus	nimisõna	B2
lõputöö	nimisõna	B2
lõtv	omadussõna	B2
lõõgastuma	tegusõna	B2
läbi elama	tegusõna	B2
läbi lööma	tegusõna	B2
läbi paistma	tegusõna	B2
läbi rääkima	tegusõna	B2
läbikäik	nimisõna	B2
läbima	tegusõna	B2
läbimurre	nimisõna	B2
läbimõõt	nimisõna	B2
läbinisti	määrsõna	B2
läbipaistvus	nimisõna	B2
läbisegi	määrsõna	B2
läbivaatus	nimisõna	B2
lähemalt	määrsõna	B2
lähetama	tegusõna	B2
lähetus	nimisõna	B2
lähiaeg	nimisõna	B2
lähipäev	nimisõna	B2
lähistel	kaassõna	B2
lähistele	kaassõna	B2
lähistelt	kaassõna	B2
lähteasend	nimisõna	B2
lähtekoht	nimisõna	B2
lähtuma	tegusõna	B2
lähtuvalt	määrsõna	B2
läikiv	omadussõna	B2
läpakas	nimisõna	B2
lärm	nimisõna	B2
lärmakas	omadussõna	B2
lärmama	tegusõna	B2
lävend	nimisõna	B2
lävi	nimisõna	B2
lühemalt	määrsõna	B2
lühend	nimisõna	B2
lühendama	tegusõna	B2
lühenema	tegusõna	B2
lühiajaline	omadussõna	B2
lühinägelik	omadussõna	B2
lükkuma	tegusõna	B2
lüli	nimisõna	B2
lüliti	nimisõna	B2
maa-alune	omadussõna	B2
maadleja	nimisõna	B2
maadlema	tegusõna	B2
maagia	nimisõna	B2
maagiline	omadussõna	B2
maailmakuulus	omadussõna	B2
maailmalõpp	nimisõna	B2
maailmameistrivõistlused	nimisõna	B2
maailmapilt	nimisõna	B2
maailmavaade	nimisõna	B2
maakera	nimisõna	B2
maakodu	nimisõna	B2
maaler	nimisõna	B2
maaletooja	nimisõna	B2
maaliline	omadussõna	B2
maaling	nimisõna	B2
maamaks	nimisõna	B2
maapealne	omadussõna	B2
maastik	nimisõna	B2
maastur	nimisõna	B2
maavalitsus	nimisõna	B2
maavanem	nimisõna	B2
maavara	nimisõna	B2
madalrõhkkond	nimisõna	B2
maestro	nimisõna	B2
maffia	nimisõna	B2
mage	omadussõna	B2
magister	nimisõna	B2
magistrant	nimisõna	B2
magneesium	nimisõna	B2
magnet	nimisõna	B2
maha raiuma	tegusõna	B2
mahe	omadussõna	B2
mahetoit	nimisõna	B2
mahlakas	omadussõna	B2
mahukas	omadussõna	B2
mahutama	tegusõna	B2
maik	nimisõna	B2
maine	nimisõna	B2
maine	omadussõna	B2
mainekas	omadussõna	B2
maitsekas	omadussõna	B2
maitseroheline	nimisõna	B2
maitsestama	tegusõna	B2
maitsetaim	nimisõna	B2
maitsetu	omadussõna	B2
maitsetus	nimisõna	B2
maius	nimisõna	B2
maiuspala	nimisõna	B2
maiustama	tegusõna	B2
maiustus	nimisõna	B2
majakas	nimisõna	B2
majandama	tegusõna	B2
majanduspoliitika	nimisõna	B2
majutama	tegusõna	B2
majutuma	tegusõna	B2
majutus	nimisõna	B2
makett	nimisõna	B2
makk	nimisõna	B2
maksekorraldus	nimisõna	B2
maksimum	nimisõna	B2
maksumaksja	nimisõna	B2
maksumus	nimisõna	B2
maksustama	tegusõna	B2
maksuvaba	omadussõna	B2
maletaja	nimisõna	B2
malev	nimisõna	B2
mall	nimisõna	B2
mandaat	nimisõna	B2
mandel	nimisõna	B2
manifest	nimisõna	B2
manipuleerima	tegusõna	B2
manustama	tegusõna	B2
manööver	nimisõna	B2
mapp	nimisõna	B2
maraton	nimisõna	B2
mardikas	nimisõna	B2
marinaad	nimisõna	B2
marineerima	tegusõna	B2
mark	nimisõna	B2
marmelaad	nimisõna	B2
marss	nimisõna	B2
marssima	tegusõna	B2
marutaud	nimisõna	B2
masendama	tegusõna	B2
masendav	omadussõna	B2
masendus	nimisõna	B2
maskeerima	tegusõna	B2
maskott	nimisõna	B2
masseerima	tegusõna	B2
massiivne	omadussõna	B2
massiline	omadussõna	B2
massiliselt	määrsõna	B2
massimeedia	nimisõna	B2
mast	nimisõna	B2
mastaap	nimisõna	B2
matemaatiline	omadussõna	B2
mats	nimisõna	B2
mats	nimisõna	B2
matš	nimisõna	B2
matt (värvi kohta)	omadussõna	B2
mattuma	tegusõna	B2
meditatsioon	nimisõna	B2
meede	nimisõna	B2
meedia	nimisõna	B2
meedik	nimisõna	B2
meedium	nimisõna	B2
meelde jätma	tegusõna	B2
meelde tuletama	tegusõna	B2
meeldetuletus	nimisõna	B2
meeleavaldaja	nimisõna	B2
meeleavaldus	nimisõna	B2
meelega	määrsõna	B2
meeleheide	nimisõna	B2
meeleheitlikult	määrsõna	B2
meelehärm	nimisõna	B2
meelelahutuslik	omadussõna	B2
meeleldi	määrsõna	B2
meelemürk	nimisõna	B2
meeleolukas	omadussõna	B2
meelepärane	omadussõna	B2
meelespea	nimisõna	B2
meeletu	omadussõna	B2
meeletult	määrsõna	B2
meelevald	nimisõna	B2
meelitama	tegusõna	B2
meelsasti	määrsõna	B2
meelt lahutama	tegusõna	B2
meeltmööda	määrsõna	B2
meene	nimisõna	B2
meenuma	tegusõna	B2
meenutus	nimisõna	B2
meeskondlik	omadussõna	B2
mehaaniline	omadussõna	B2
mehelik	omadussõna	B2
mehine	omadussõna	B2
meikima	tegusõna	B2
meisterdama	tegusõna	B2
meistriteos	nimisõna	B2
meistrivõistlused	nimisõna	B2
melodraama	nimisõna	B2
memm	nimisõna	B2
memorandum	nimisõna	B2
menetlus	nimisõna	B2
menstruatsioon	nimisõna	B2
mentaalne	omadussõna	B2
mentor	nimisõna	B2
menu	nimisõna	B2
menukas	omadussõna	B2
merendus	nimisõna	B2
merevägi	nimisõna	B2
mesindus	nimisõna	B2
mesinik	nimisõna	B2
mess	nimisõna	B2
metoodika	nimisõna	B2
metsandus	nimisõna	B2
metsik	omadussõna	B2
metsikult	määrsõna	B2
metslane	nimisõna	B2
metsnik	nimisõna	B2
miin	nimisõna	B2
miinimum	nimisõna	B2
miiting	nimisõna	B2
miljardär	nimisõna	B2
miljonär	nimisõna	B2
miljöö	nimisõna	B2
millalgi	määrsõna	B2
mineraal	nimisõna	B2
minia	nimisõna	B2
minimaalne	omadussõna	B2
misjaoks	määrsõna	B2
misjonär	nimisõna	B2
misjärel	määrsõna	B2
miskipärast	määrsõna	B2
mismoodi	määrsõna	B2
mispeale	määrsõna	B2
mispärast	määrsõna	B2
missioon	nimisõna	B2
mistahes	määrsõna	B2
mistõttu	määrsõna	B2
mitmeaastane	omadussõna	B2
mitmekesi	määrsõna	B2
mitmekesine	omadussõna	B2
mitmekesisus	nimisõna	B2
mitmekordistama	tegusõna	B2
mitmekordne	omadussõna	B2
mitmekordselt	määrsõna	B2
mitmekülgne	omadussõna	B2
mitmekülgsus	nimisõna	B2
mitmeti	määrsõna	B2
mobiilne	omadussõna	B2
mobiilsus	nimisõna	B2
mobiliseerima	tegusõna	B2
modem	nimisõna	B2
moderniseerima	tegusõna	B2
modernne	omadussõna	B2
moel	kaassõna	B2
molekul	nimisõna	B2
monitor	nimisõna	B2
monopol	nimisõna	B2
monstrum	nimisõna	B2
monteerima	tegusõna	B2
monument	nimisõna	B2
moodul	nimisõna	B2
moodus	nimisõna	B2
moodustis	nimisõna	B2
moodustuma	tegusõna	B2
moraal	nimisõna	B2
moraalne	omadussõna	B2
moraalselt	määrsõna	B2
moslem	nimisõna	B2
mošee	nimisõna	B2
motiiv	nimisõna	B2
motivatsioon	nimisõna	B2
motiveerima	tegusõna	B2
moto	nimisõna	B2
muda	nimisõna	B2
mudilane	nimisõna	B2
muhk	nimisõna	B2
muide	määrsõna	B2
muigama	tegusõna	B2
muinasaeg	nimisõna	B2
muinasjutt	nimisõna	B2
muinsuskaitse	nimisõna	B2
muistend	nimisõna	B2
muistne	omadussõna	B2
muljetavaldav	omadussõna	B2
mull	nimisõna	B2
mullu	määrsõna	B2
multimeedia	nimisõna	B2
mumps	nimisõna	B2
munarakk	nimisõna	B2
munder	nimisõna	B2
munema	tegusõna	B2
munk	nimisõna	B2
murakas	nimisõna	B2
murd	nimisõna	B2
murduma	tegusõna	B2
muretu	omadussõna	B2
murrang	nimisõna	B2
murre	nimisõna	B2
musitseerima	tegusõna	B2
muskel	nimisõna	B2
mustama	tegusõna	B2
mustanahaline	omadussõna	B2
mustand	nimisõna	B2
mustkunstnik	nimisõna	B2
mustlane	nimisõna	B2
mustus	nimisõna	B2
mutrivõti	nimisõna	B2
mutt	nimisõna	B2
mutter	nimisõna	B2
muudkui	määrsõna	B2
muuhulgas	määrsõna	B2
muukeelne	omadussõna	B2
muulane	nimisõna	B2
muusikaline	omadussõna	B2
muutumatu	omadussõna	B2
mõeldamatu	omadussõna	B2
mõisnik	nimisõna	B2
mõistagi	määrsõna	B2
mõistatama	tegusõna	B2
mõiste	nimisõna	B2
mõistetamatu	omadussõna	B2
mõistlikkus	nimisõna	B2
mõistmatus	nimisõna	B2
mõistvalt	määrsõna	B2
mõjukas	omadussõna	B2
mõjul	kaassõna	B2
mõjus	omadussõna	B2
mõjutus	nimisõna	B2
mõjuv	omadussõna	B2
mõneti	määrsõna	B2
mõnevõrra	määrsõna	B2
mõningane	asesõna	B2
mõningas	asesõna	B2
mõnitama	tegusõna	B2
mõnu	nimisõna	B2
mõnuaine	nimisõna	B2
mõnusalt	määrsõna	B2
mõnusasti	määrsõna	B2
mõra	nimisõna	B2
mõrtsukas	nimisõna	B2
mõrvama	tegusõna	B2
mõtestama	tegusõna	B2
mõtisklema	tegusõna	B2
mõtisklus	nimisõna	B2
mõtlemapanev	omadussõna	B2
mõtlik	omadussõna	B2
mõttekaaslane	nimisõna	B2
mõttekas	omadussõna	B2
mõttekriips	nimisõna	B2
mõttekäik	nimisõna	B2
mõtteline	omadussõna	B2
mõttetult	määrsõna	B2
mõttetus	nimisõna	B2
mõttevahetus	nimisõna	B2
mõtteviis	nimisõna	B2
mõõdik	nimisõna	B2
mõõdukalt	määrsõna	B2
mõõdupuu	nimisõna	B2
mõõt	nimisõna	B2
mõõteriist	nimisõna	B2
mõõtühik	nimisõna	B2
mädanema	tegusõna	B2
mäger	nimisõna	B2
mägine	omadussõna	B2
mähe	nimisõna	B2
mälestama	tegusõna	B2
mälestis	nimisõna	B2
mälestussammas	nimisõna	B2
mäletatavasti	määrsõna	B2
mälumäng	nimisõna	B2
mänedžer	nimisõna	B2
mängukava	nimisõna	B2
mänguline	omadussõna	B2
märge	nimisõna	B2
märge	nimisõna	B2
märgistama	tegusõna	B2
märgistus	nimisõna	B2
märguanne	nimisõna	B2
märkamatu	omadussõna	B2
märkamatult	määrsõna	B2
märkimisväärne	omadussõna	B2
märkimisväärselt	määrsõna	B2
märkmik	nimisõna	B2
märksa	määrsõna	B2
märksõna	nimisõna	B2
märku andma	tegusõna	B2
mässama	tegusõna	B2
mässuline	omadussõna	B2
mätas	nimisõna	B2
määramatus	nimisõna	B2
määratlema	tegusõna	B2
määratlus	nimisõna	B2
määrav	omadussõna	B2
määrduma	tegusõna	B2
määre	nimisõna	B2
määrus	nimisõna	B2
möll	nimisõna	B2
möödapääsmatu	omadussõna	B2
möödas	määrsõna	B2
mööndus	nimisõna	B2
möönma	tegusõna	B2
münt	nimisõna	B2
mürgistus	nimisõna	B2
mürgitama	tegusõna	B2
mürsk	nimisõna	B2
müsteerium	nimisõna	B2
müstika	nimisõna	B2
müstiline	omadussõna	B2
mütoloogia	nimisõna	B2
müüt	nimisõna	B2
müütiline	omadussõna	B2
naabrivalve	nimisõna	B2
naabrus	nimisõna	B2
naarits	nimisõna	B2
naasma	tegusõna	B2
naba	nimisõna	B2
nael	nimisõna	B2
naeruväärne	omadussõna	B2
nafta	nimisõna	B2
nagunii	määrsõna	B2
nahahaigus	nimisõna	B2
nahkhiir	nimisõna	B2
naiivne	omadussõna	B2
naiselik	omadussõna	B2
najal	kaassõna	B2
najale	kaassõna	B2
nakatama	tegusõna	B2
nakatuma	tegusõna	B2
nakkama	tegusõna	B2
nakkus	nimisõna	B2
naljalt	määrsõna	B2
naljatama	tegusõna	B2
napilt	määrsõna	B2
nappus	nimisõna	B2
naps	nimisõna	B2
narkomaania	nimisõna	B2
narrima	tegusõna	B2
nastik	nimisõna	B2
nats	nimisõna	B2
nauding	nimisõna	B2
needma	tegusõna	B2
needus	nimisõna	B2
neid	nimisõna	B2
neitsi	nimisõna	B2
nelik	nimisõna	B2
neutraalne	omadussõna	B2
nihe	nimisõna	B2
nihutama	tegusõna	B2
nii-öelda	määrsõna	B2
niiduk	nimisõna	B2
niigi	määrsõna	B2
niikaua	määrsõna	B2
niinimetatud	omadussõna	B2
niipalju	määrsõna	B2
niipea	määrsõna	B2
niisamuti	määrsõna	B2
niiskus	nimisõna	B2
niisutama	tegusõna	B2
niit	nimisõna	B2
niitma	tegusõna	B2
niiviisi	määrsõna	B2
niivõrd	määrsõna	B2
niivõrd-kuivõrd	määrsõna	B2
niiöelda	määrsõna	B2
nimekas	omadussõna	B2
nimistu	nimisõna	B2
ninasarvik	nimisõna	B2
nipp	nimisõna	B2
nišš	nimisõna	B2
nokitsema	tegusõna	B2
nokk	nimisõna	B2
nokkima	tegusõna	B2
nominent	nimisõna	B2
noogutama	tegusõna	B2
nool	nimisõna	B2
noomitus	nimisõna	B2
noorelt	määrsõna	B2
noorpaar	nimisõna	B2
nooruke	omadussõna	B2
noorus	nimisõna	B2
nooruslik	omadussõna	B2
noot	nimisõna	B2
noppima	tegusõna	B2
norima	tegusõna	B2
norskama	tegusõna	B2
nostalgia	nimisõna	B2
nostalgiline	omadussõna	B2
novell	nimisõna	B2
nukk	nimisõna	B2
nukrus	nimisõna	B2
nullima	tegusõna	B2
nunn	nimisõna	B2
nunnu	nimisõna	B2
nupp	nimisõna	B2
nurruma	tegusõna	B2
nutikas	omadussõna	B2
nutiseade	nimisõna	B2
nuuskama	tegusõna	B2
nuusutama	tegusõna	B2
nõbu	nimisõna	B2
nõel	nimisõna	B2
nõges	nimisõna	B2
nõid	nimisõna	B2
nõks	nimisõna	B2
nõme	omadussõna	B2
nõmm	nimisõna	B2
nõnda	määrsõna	B2
nõrgendama	tegusõna	B2
nõrgenema	tegusõna	B2
nõrgestama	tegusõna	B2
nõuandja	nimisõna	B2
nõuanne	nimisõna	B2
nõudlus	nimisõna	B2
nõuetekohane	omadussõna	B2
nõuetekohaselt	määrsõna	B2
nõukoda	nimisõna	B2
nõunik	nimisõna	B2
nõupidamine	nimisõna	B2
nõutav	omadussõna	B2
nõutu	omadussõna	B2
nägemus	nimisõna	B2
nägus	omadussõna	B2
nähtamatu	omadussõna	B2
nähtav	omadussõna	B2
nähtaval	määrsõna	B2
nähtavale	määrsõna	B2
nähtavasti	määrsõna	B2
nähtavus	nimisõna	B2
näiline	omadussõna	B2
näiliselt	määrsõna	B2
näitemäng	nimisõna	B2
näitlema	tegusõna	B2
nälg	nimisõna	B2
nälgima	tegusõna	B2
näol	kaassõna	B2
näpistama	tegusõna	B2
näpp	nimisõna	B2
näppima	tegusõna	B2
näpunäide	nimisõna	B2
närima	tegusõna	B2
nööp	nimisõna	B2
nüanss	nimisõna	B2
nüri	omadussõna	B2
nüüdisaeg	nimisõna	B2
nüüdne	omadussõna	B2
objektiiv	nimisõna	B2
objektiivne	omadussõna	B2
objektiivselt	määrsõna	B2
observatoorium	nimisõna	B2
oda	nimisõna	B2
odavnema	tegusõna	B2
ohjeldama	tegusõna	B2
ohjeldamatu	omadussõna	B2
ohtralt	määrsõna	B2
ohustama	tegusõna	B2
ohutult	määrsõna	B2
ohutus	nimisõna	B2
ohverdama	tegusõna	B2
ohvitser	nimisõna	B2
okaspuu	nimisõna	B2
oksjon	nimisõna	B2
okupatsioon	nimisõna	B2
okupeerima	tegusõna	B2
olemasolu	nimisõna	B2
olematu	omadussõna	B2
olemus	nimisõna	B2
olemuslik	omadussõna	B2
olend	nimisõna	B2
olenevalt	määrsõna	B2
oletama	tegusõna	B2
oletatavasti	määrsõna	B2
oletus	nimisõna	B2
olevik	nimisõna	B2
olgugi	sidesõna	B2
oligarh	nimisõna	B2
olme	nimisõna	B2
olmejäätmed	nimisõna	B2
olu	nimisõna	B2
olulisus	nimisõna	B2
olümpia	nimisõna	B2
oma	nimisõna	B2
oma	määrsõna	B2
omaaegne	omadussõna	B2
omadus	nimisõna	B2
omaenese	asesõna	B2
omakasu	nimisõna	B2
omaksed	nimisõna	B2
omaksvõtt	nimisõna	B2
omamoodi	määrsõna	B2
omandus	nimisõna	B2
omanäoline	omadussõna	B2
omapoolne	omadussõna	B2
omapäi	määrsõna	B2
omapära	nimisõna	B2
omaselt	määrsõna	B2
omastama	tegusõna	B2
omasugune	asesõna	B2
omavalitsus	nimisõna	B2
omavoliline	omadussõna	B2
omavoliliselt	määrsõna	B2
ometigi	määrsõna	B2
omistama	tegusõna	B2
ootamatus	nimisõna	B2
ootuspärane	omadussõna	B2
operaator	nimisõna	B2
operatiivne	omadussõna	B2
opereerima	tegusõna	B2
operett	nimisõna	B2
oponeerima	tegusõna	B2
oponent	nimisõna	B2
opositsioon	nimisõna	B2
optiline	omadussõna	B2
optimaalne	omadussõna	B2
optimeerima	tegusõna	B2
optimism	nimisõna	B2
orb	nimisõna	B2
orbiit	nimisõna	B2
orden	nimisõna	B2
org	nimisõna	B2
orgaaniline	omadussõna	B2
orgasm	nimisõna	B2
orhidee	nimisõna	B2
ori	nimisõna	B2
orientatsioon	nimisõna	B2
orienteerima	tegusõna	B2
orienteeruma	tegusõna	B2
orienteeruvalt	määrsõna	B2
originaal	nimisõna	B2
originaalne	omadussõna	B2
orjus	nimisõna	B2
orkaan	nimisõna	B2
osak	nimisõna	B2
osakaal	nimisõna	B2
osalt	määrsõna	B2
osalus	nimisõna	B2
osanik	nimisõna	B2
osapool	nimisõna	B2
osas	kaassõna	B2
osatähtsus	nimisõna	B2
osatäitja	nimisõna	B2
osav	omadussõna	B2
osavalt	määrsõna	B2
osavus	nimisõna	B2
oskamatus	nimisõna	B2
oskuslikult	määrsõna	B2
oskusteave	nimisõna	B2
osutuma	tegusõna	B2
otsapidi	määrsõna	B2
otsast	kaassõna	B2
otsekorraldus	nimisõna	B2
otsekui	määrsõna	B2
otsesaade	nimisõna	B2
otseselt	määrsõna	B2
otseülekanne	nimisõna	B2
otsing	nimisõna	B2
otstarbekus	nimisõna	B2
otstarve	nimisõna	B2
otsustavalt	määrsõna	B2
otsustus	nimisõna	B2
otsustusvõimeline	omadussõna	B2
otsustusõigus	nimisõna	B2
paabulind	nimisõna	B2
paak	nimisõna	B2
paariline	nimisõna	B2
paaris	määrsõna	B2
paast	nimisõna	B2
paastuma	tegusõna	B2
paavst	nimisõna	B2
pabistama	tegusõna	B2
pada	nimisõna	B2
padrun	nimisõna	B2
paekivi	nimisõna	B2
pael	nimisõna	B2
pagan	nimisõna	B2
paganlik	omadussõna	B2
pagulane	nimisõna	B2
paha	nimisõna	B2
pahameel	nimisõna	B2
pahatahtlik	omadussõna	B2
pahatihti	määrsõna	B2
pai	nimisõna	B2
paigaldus	nimisõna	B2
paiguti	määrsõna	B2
paigutus	nimisõna	B2
paika pidama	tegusõna	B2
paikne	omadussõna	B2
paindlikkus	nimisõna	B2
painduma	tegusõna	B2
painutama	tegusõna	B2
paistetus	nimisõna	B2
paju	nimisõna	B2
pakend	nimisõna	B2
pakendama	tegusõna	B2
pakett	nimisõna	B2
pakihoid	nimisõna	B2
pakk	nimisõna	B2
paksus	nimisõna	B2
pakt	nimisõna	B2
pala	nimisõna	B2
palat	nimisõna	B2
palavus	nimisõna	B2
palee	nimisõna	B2
palganumber	nimisõna	B2
palgapäev	nimisõna	B2
palgatase	nimisõna	B2
paljajalu	määrsõna	B2
paljalt	määrsõna	B2
paljastama	tegusõna	B2
paljundama	tegusõna	B2
paljunema	tegusõna	B2
paljusus	nimisõna	B2
palkama	tegusõna	B2
palm	nimisõna	B2
palvus	nimisõna	B2
panda	nimisõna	B2
pandimaja	nimisõna	B2
paneel	nimisõna	B2
pang	nimisõna	B2
pangandus	nimisõna	B2
panipaik	nimisõna	B2
pank	nimisõna	B2
pankrotistuma	tegusõna	B2
pansionaat	nimisõna	B2
pant	nimisõna	B2
pantima	tegusõna	B2
pantvang	nimisõna	B2
panus	nimisõna	B2
panustama	tegusõna	B2
papagoi	nimisõna	B2
paradigma	nimisõna	B2
paradiis	nimisõna	B2
paradoks	nimisõna	B2
parajasti	määrsõna	B2
paralleel	nimisõna	B2
paralleelne	omadussõna	B2
paralleelselt	määrsõna	B2
parameeter	nimisõna	B2
parasiit	nimisõna	B2
parasjagu	määrsõna	B2
parasportlane	nimisõna	B2
paratamatu	omadussõna	B2
paratamatult	määrsõna	B2
paratamatus	nimisõna	B2
pardakaart	nimisõna	B2
paremik	nimisõna	B2
parempoolne	omadussõna	B2
paremus	nimisõna	B2
paremusjärjestus	nimisõna	B2
parendama	tegusõna	B2
parkett	nimisõna	B2
parlamentaarne	omadussõna	B2
parm	nimisõna	B2
parras	nimisõna	B2
parukas	nimisõna	B2
parv	nimisõna	B2
parvlaev	nimisõna	B2
passiivne	omadussõna	B2
pasun	nimisõna	B2
pataljon	nimisõna	B2
patarei	nimisõna	B2
patent	nimisõna	B2
patriarh	nimisõna	B2
patrioot	nimisõna	B2
patrull	nimisõna	B2
pats	nimisõna	B2
patt	nimisõna	B2
patune	omadussõna	B2
pauk	nimisõna	B2
paviljon	nimisõna	B2
pea	määrsõna	B2
peaasi	nimisõna	B2
peale tulema	tegusõna	B2
pealegi	määrsõna	B2
pealekauba	määrsõna	B2
pealetung	nimisõna	B2
pealik	nimisõna	B2
pealiskaudne	omadussõna	B2
pealmine	omadussõna	B2
pealt kuulama	tegusõna	B2
pealt nägema	tegusõna	B2
pealtnägija	nimisõna	B2
pealtnäha	määrsõna	B2
pealtpoolt	kaassõna	B2
peaproov	nimisõna	B2
pearinglus	nimisõna	B2
peatselt	määrsõna	B2
peatükk	nimisõna	B2
peavari	nimisõna	B2
pedaal	nimisõna	B2
pedagoogika	nimisõna	B2
pedagoogiline	omadussõna	B2
pedofiil	nimisõna	B2
peegeldama	tegusõna	B2
peegelduma	tegusõna	B2
peenis	nimisõna	B2
pehmendama	tegusõna	B2
peidukoht	nimisõna	B2
peidus	määrsõna	B2
peitu	määrsõna	B2
pekk	nimisõna	B2
peldik	nimisõna	B2
peletama	tegusõna	B2
pelgalt	määrsõna	B2
pelgama	tegusõna	B2
pendel	nimisõna	B2
peni	nimisõna	B2
peopesa	nimisõna	B2
peotants	nimisõna	B2
perekondlik	omadussõna	B2
perfektne	omadussõna	B2
perioodiline	omadussõna	B2
personaalne	omadussõna	B2
personal	nimisõna	B2
persoon	nimisõna	B2
perspektiiv	nimisõna	B2
perspektiivikas	omadussõna	B2
perspektiivitu	omadussõna	B2
pesitsema	tegusõna	B2
petis	nimisõna	B2
petlik	omadussõna	B2
pettumus	nimisõna	B2
pettur	nimisõna	B2
pidurduma	tegusõna	B2
pidustus	nimisõna	B2
pidutsema	tegusõna	B2
pigistama	tegusõna	B2
pihk	nimisõna	B2
pihta	määrsõna	B2
pihustama	tegusõna	B2
piibel	nimisõna	B2
piibeleht	nimisõna	B2
piin	nimisõna	B2
piinama	tegusõna	B2
piinlema	tegusõna	B2
piinlikkus	nimisõna	B2
piip	nimisõna	B2
piiramatu	omadussõna	B2
piiramatult	määrsõna	B2
piirang	nimisõna	B2
piirduma	tegusõna	B2
piiriala	nimisõna	B2
piirikontroll	nimisõna	B2
piiripunkt	nimisõna	B2
piiritlema	tegusõna	B2
piiritu	omadussõna	B2
piiritus	nimisõna	B2
piirkondlik	omadussõna	B2
piirnema	tegusõna	B2
piisk	nimisõna	B2
piiskop	nimisõna	B2
piits	nimisõna	B2
pikaaegne	omadussõna	B2
pikapeale	määrsõna	B2
pikemalt	määrsõna	B2
pikendus	nimisõna	B2
pikendusjuhe	nimisõna	B2
pikenema	tegusõna	B2
pikett	nimisõna	B2
piki	kaassõna	B2
piksel	nimisõna	B2
pikutama	tegusõna	B2
pilgutama	tegusõna	B2
piljard	nimisõna	B2
pill	nimisõna	B2
pilliroog	nimisõna	B2
piltlik	omadussõna	B2
piltlikult	määrsõna	B2
pilvelõhkuja	nimisõna	B2
pilvik	nimisõna	B2
pilvisus	nimisõna	B2
pimestama	tegusõna	B2
pinal	nimisõna	B2
pind	nimisõna	B2
pindmine	omadussõna	B2
pingeline	omadussõna	B2
pingerida	nimisõna	B2
pingevaba	omadussõna	B2
pinginaaber	nimisõna	B2
pingutus	nimisõna	B2
pingviin	nimisõna	B2
pinnas	nimisõna	B2
pipratoos	nimisõna	B2
piraat	nimisõna	B2
piraatlus	nimisõna	B2
pisiasi	nimisõna	B2
pisik	nimisõna	B2
pissima	tegusõna	B2
pistik	nimisõna	B2
pistma	tegusõna	B2
pisuke	omadussõna	B2
pits	nimisõna	B2
pits	nimisõna	B2
pitsat	nimisõna	B2
pitser	nimisõna	B2
pjedestaal	nimisõna	B2
plaaniline	omadussõna	B2
plaanipärane	omadussõna	B2
plaaster	nimisõna	B2
plakat	nimisõna	B2
planeering	nimisõna	B2
planeet	nimisõna	B2
plank	nimisõna	B2
plast	nimisõna	B2
plastik	nimisõna	B2
plastiliin	nimisõna	B2
platvorm	nimisõna	B2
plekiline	omadussõna	B2
plekk	nimisõna	B2
plika	nimisõna	B2
plokk	nimisõna	B2
plokkflööt	nimisõna	B2
plomm	nimisõna	B2
plätu	nimisõna	B2
poeem	nimisõna	B2
poeet	nimisõna	B2
poeetiline	omadussõna	B2
pohmell	nimisõna	B2
poissmees	nimisõna	B2
poksima	tegusõna	B2
poleemika	nimisõna	B2
poliis	nimisõna	B2
politoloog	nimisõna	B2
polt	nimisõna	B2
pommitama	tegusõna	B2
poni	nimisõna	B2
poogen	nimisõna	B2
pooldaja	nimisõna	B2
poolehoid	nimisõna	B2
poolehoidja	nimisõna	B2
pooleks	määrsõna	B2
pooleldi	määrsõna	B2
poolenisti	määrsõna	B2
poolik	nimisõna	B2
poolik	omadussõna	B2
poolkera	nimisõna	B2
poolus	nimisõna	B2
poom	nimisõna	B2
pooma	tegusõna	B2
poos	nimisõna	B2
popitama	tegusõna	B2
popp	nimisõna	B2
popp (õigeusu preester)	nimisõna	B2
popp	omadussõna	B2
populism	nimisõna	B2
populistlik	omadussõna	B2
portaal	nimisõna	B2
portselan	nimisõna	B2
portsjon	nimisõna	B2
poseerima	tegusõna	B2
positiivsus	nimisõna	B2
postitama	tegusõna	B2
postitus	nimisõna	B2
potentsiaal	nimisõna	B2
potentsiaalne	omadussõna	B2
potentsiaalselt	määrsõna	B2
praak	nimisõna	B2
pragmaatiline	omadussõna	B2
pragu	nimisõna	B2
praktikant	nimisõna	B2
prefekt	nimisõna	B2
prefektuur	nimisõna	B2
premeerima	tegusõna	B2
presentatsioon	nimisõna	B2
press	nimisõna	B2
press	nimisõna	B2
pressiteade	nimisõna	B2
prestiiž	nimisõna	B2
prestiižne	omadussõna	B2
pretendeerima	tegusõna	B2
pretensioon	nimisõna	B2
pretsedent	nimisõna	B2
primitiivne	omadussõna	B2
prints	nimisõna	B2
printsess	nimisõna	B2
printsiip	nimisõna	B2
prioriteet	nimisõna	B2
prioriteetne	omadussõna	B2
pritsima	tegusõna	B2
privaatne	omadussõna	B2
privaatsus	nimisõna	B2
privileeg	nimisõna	B2
problemaatika	nimisõna	B2
problemaatiline	omadussõna	B2
produkt	nimisõna	B2
produktiivne	omadussõna	B2
produtseerima	tegusõna	B2
produtsent	nimisõna	B2
professionaal	nimisõna	B2
professionaalselt	määrsõna	B2
professionaalsus	nimisõna	B2
proff	nimisõna	B2
profiil	nimisõna	B2
profülaktika	nimisõna	B2
prognoos	nimisõna	B2
prognoosima	tegusõna	B2
programmeerima	tegusõna	B2
progress	nimisõna	B2
progressiivne	omadussõna	B2
prohvet	nimisõna	B2
projekteerima	tegusõna	B2
prokuratuur	nimisõna	B2
promill	nimisõna	B2
pronksiaeg	nimisõna	B2
proosa	nimisõna	B2
propaganda	nimisõna	B2
propageerima	tegusõna	B2
proportsioon	nimisõna	B2
pross	nimisõna	B2
prostitutsioon	nimisõna	B2
prostituut	nimisõna	B2
protees	nimisõna	B2
proteiin	nimisõna	B2
protestant	nimisõna	B2
protestantlik	omadussõna	B2
protesteerima	tegusõna	B2
protestima	tegusõna	B2
protokoll	nimisõna	B2
prototüüp	nimisõna	B2
protseduuriline	omadussõna	B2
protsessor	nimisõna	B2
provokatsioon	nimisõna	B2
provotseerima	tegusõna	B2
pruukima	tegusõna	B2
pruut	nimisõna	B2
prügila	nimisõna	B2
prügivedu	nimisõna	B2
pseudonüüm	nimisõna	B2
psüühika	nimisõna	B2
psüühiline	omadussõna	B2
puberteet	nimisõna	B2
pubi	nimisõna	B2
publikatsioon	nimisõna	B2
pugema	tegusõna	B2
puhaskasum	nimisõna	B2
puhkema	tegusõna	B2
puhtand	nimisõna	B2
puhvet	nimisõna	B2
puit	nimisõna	B2
pukk	nimisõna	B2
pulber	nimisõna	B2
puljong	nimisõna	B2
pull	nimisõna	B2
pulss	nimisõna	B2
pump	nimisõna	B2
pumpama	tegusõna	B2
punastama	tegusõna	B2
punetama	tegusõna	B2
punetus	nimisõna	B2
pung	nimisõna	B2
punn	nimisõna	B2
punt	nimisõna	B2
punuma	tegusõna	B2
puravik	nimisõna	B2
purjekas	nimisõna	B2
purjetama	tegusõna	B2
purju	määrsõna	B2
purk	nimisõna	B2
purskama	tegusõna	B2
puru	nimisõna	B2
puruks	määrsõna	B2
pusle	nimisõna	B2
putukas	nimisõna	B2
puuder	nimisõna	B2
puudu jääma	tegusõna	B2
puudujääk	nimisõna	B2
puudulik	omadussõna	B2
puudulikkus	nimisõna	B2
puudutus	nimisõna	B2
puurima	tegusõna	B2
puuteekraan	nimisõna	B2
puutetundlik	omadussõna	B2
puutumatu	omadussõna	B2
puuvillane	omadussõna	B2
põgenik	nimisõna	B2
põgus	omadussõna	B2
põhikiri	nimisõna	B2
põhimäärus	nimisõna	B2
põhirõhk	nimisõna	B2
põhiseaduslik	omadussõna	B2
põhitõde	nimisõna	B2
põhjalikkus	nimisõna	B2
põhjalikumalt	määrsõna	B2
põhjanaba	nimisõna	B2
põhjendamatu	omadussõna	B2
põimuma	tegusõna	B2
põis	nimisõna	B2
põleng	nimisõna	B2
põliselanik	nimisõna	B2
põlisrahvas	nimisõna	B2
põllumajanduslik	omadussõna	B2
põnevik	nimisõna	B2
põnevus	nimisõna	B2
põnn	nimisõna	B2
põrandaalune	nimisõna	B2
põrandaalune	omadussõna	B2
põrgu	nimisõna	B2
põrkuma	tegusõna	B2
põrm	nimisõna	B2
põrnikas	nimisõna	B2
põrutama	tegusõna	B2
pädev	omadussõna	B2
pädevus	nimisõna	B2
päevakord	nimisõna	B2
päevalill	nimisõna	B2
päevapealt	määrsõna	B2
pähklipuu	nimisõna	B2
päikesepaisteline	omadussõna	B2
päis	nimisõna	B2
päkapikk	nimisõna	B2
pälvima	tegusõna	B2
päralt	kaassõna	B2
pärand	nimisõna	B2
pärandama	tegusõna	B2
pärandus	nimisõna	B2
pärastpoole	määrsõna	B2
pärg	nimisõna	B2
pärilik	omadussõna	B2
pärilikkus	nimisõna	B2
pärimus	nimisõna	B2
päring	nimisõna	B2
päriselt	määrsõna	B2
pärismaalane	nimisõna	B2
pärl	nimisõna	B2
pärm	nimisõna	B2
pärusmaa	nimisõna	B2
päts	nimisõna	B2
pätt	nimisõna	B2
pääs	nimisõna	B2
pääse	nimisõna	B2
päästeteenistus	nimisõna	B2
pöialpoiss	nimisõna	B2
pöörane	omadussõna	B2
pööraselt	määrsõna	B2
pöördepunkt	nimisõna	B2
pöördumatu	omadussõna	B2
pöörlema	tegusõna	B2
pühak	nimisõna	B2
pühakiri	nimisõna	B2
pühakoda	nimisõna	B2
pühenduma	tegusõna	B2
pühendumus	nimisõna	B2
pühitsema	tegusõna	B2
püramiid	nimisõna	B2
pürgima	tegusõna	B2
püsiv	omadussõna	B2
püsivalt	määrsõna	B2
püsivus	nimisõna	B2
püsiühendus	nimisõna	B2
püss	nimisõna	B2
püstine	omadussõna	B2
püüdlik	omadussõna	B2
püüdlikkus	nimisõna	B2
püüdlus	nimisõna	B2
raadius	nimisõna	B2
raamistik	nimisõna	B2
rabelema	tegusõna	B2
radar	nimisõna	B2
radikaalne	omadussõna	B2
radioaktiivne	omadussõna	B2
raev	nimisõna	B2
rahapesu	nimisõna	B2
rahastus	nimisõna	B2
rahatäht	nimisõna	B2
rahuldav	omadussõna	B2
rahulduma	tegusõna	B2
rahuldus	nimisõna	B2
rahulolematu	omadussõna	B2
rahulolematus	nimisõna	B2
rahulolev	omadussõna	B2
rahulolu	nimisõna	B2
rahumeeli	määrsõna	B2
rahumeelne	omadussõna	B2
rahumeelselt	määrsõna	B2
rahunema	tegusõna	B2
rahutu	omadussõna	B2
rahutus	nimisõna	B2
rahvaarv	nimisõna	B2
rahvahääletus	nimisõna	B2
rahvalik	omadussõna	B2
rahvaloendus	nimisõna	B2
rahvaluule	nimisõna	B2
rahvapärane	omadussõna	B2
rahvariided	nimisõna	B2
rahvarohke	omadussõna	B2
rahvastik	nimisõna	B2
rahvuseepos	nimisõna	B2
rahvuskaaslane	nimisõna	B2
rahvuskoondis	nimisõna	B2
rahvuslane	nimisõna	B2
rahvuslus	nimisõna	B2
rahvusvähemus	nimisõna	B2
rajanema	tegusõna	B2
rajatis	nimisõna	B2
rakendama	tegusõna	B2
rakenduma	tegusõna	B2
rakendus	nimisõna	B2
rakenduskõrgkool	nimisõna	B2
rakenduslik	omadussõna	B2
rakett	nimisõna	B2
rakk	nimisõna	B2
ralli	nimisõna	B2
rangus	nimisõna	B2
rannik	nimisõna	B2
raporteerima	tegusõna	B2
raps	nimisõna	B2
rasedus	nimisõna	B2
raseerima	tegusõna	B2
rasestuma	tegusõna	B2
rasestumisvastane	omadussõna	B2
raskekujuline	omadussõna	B2
raskendama	tegusõna	B2
raskusaste	nimisõna	B2
rassism	nimisõna	B2
rasvatu	omadussõna	B2
ratsionaalne	omadussõna	B2
rauaaeg	nimisõna	B2
raudselt	määrsõna	B2
reaalselt	määrsõna	B2
reaalsus	nimisõna	B2
reageering	nimisõna	B2
reaktor	nimisõna	B2
reaktsioon	nimisõna	B2
realiseerima	tegusõna	B2
realiseeruma	tegusõna	B2
realist	nimisõna	B2
realistlik	omadussõna	B2
reastama	tegusõna	B2
rebenema	tegusõna	B2
reeglistik	nimisõna	B2
reetma	tegusõna	B2
reetur	nimisõna	B2
referaat	nimisõna	B2
referendum	nimisõna	B2
refleks	nimisõna	B2
reformima	tegusõna	B2
refrään	nimisõna	B2
regatt	nimisõna	B2
regionaalne	omadussõna	B2
regioon	nimisõna	B2
register	nimisõna	B2
registreering	nimisõna	B2
registreeruma	tegusõna	B2
regulaarne	omadussõna	B2
regulaator	nimisõna	B2
regulatsioon	nimisõna	B2
rehkendama	tegusõna	B2
reid	nimisõna	B2
reiting	nimisõna	B2
rekonstrueerima	tegusõna	B2
rektor	nimisõna	B2
religioon	nimisõna	B2
religioosne	omadussõna	B2
reliikvia	nimisõna	B2
relvajõud	nimisõna	B2
relvastama	tegusõna	B2
relvastus	nimisõna	B2
renoveerima	tegusõna	B2
reostama	tegusõna	B2
reostuma	tegusõna	B2
reostus	nimisõna	B2
reovesi	nimisõna	B2
repertuaar	nimisõna	B2
repliik	nimisõna	B2
reportaaž	nimisõna	B2
reporter	nimisõna	B2
reserv	nimisõna	B2
residents	nimisõna	B2
resolutsioon	nimisõna	B2
respekt	nimisõna	B2
respekteerima	tegusõna	B2
rest	nimisõna	B2
restaureerima	tegusõna	B2
resultaat	nimisõna	B2
resultatiivne	omadussõna	B2
režiim	nimisõna	B2
retk	nimisõna	B2
retoorika	nimisõna	B2
retsensioon	nimisõna	B2
revisjon	nimisõna	B2
revolutsioon	nimisõna	B2
revolutsiooniline	omadussõna	B2
riba	nimisõna	B2
ribi	nimisõna	B2
ridamisi	määrsõna	B2
riid	nimisõna	B2
riietama	tegusõna	B2
riietuma	tegusõna	B2
riigikord	nimisõna	B2
riigilõiv	nimisõna	B2
riigipea	nimisõna	B2
riigipoolne	omadussõna	B2
riigisektor	nimisõna	B2
riigisisene	omadussõna	B2
riigitelevisioon	nimisõna	B2
riiklus	nimisõna	B2
riisikas	nimisõna	B2
riist	nimisõna	B2
riistvara	nimisõna	B2
riisuma	tegusõna	B2
riiv	nimisõna	B2
riivima	tegusõna	B2
rikastama	tegusõna	B2
rikastuma	tegusõna	B2
rikkalik	omadussõna	B2
rikkur	nimisõna	B2
rindkere	nimisõna	B2
ringhääling	nimisõna	B2
ringi	kaassõna	B2
ringis	kaassõna	B2
ringkond	nimisõna	B2
ringlema	tegusõna	B2
ringlus	nimisõna	B2
ringtee	nimisõna	B2
rinne	nimisõna	B2
riskantne	omadussõna	B2
ristiusk	nimisõna	B2
ristkülik	nimisõna	B2
rituaal	nimisõna	B2
rivaal	nimisõna	B2
rivi	nimisõna	B2
rohelus	nimisõna	B2
rohima	tegusõna	B2
rohke	omadussõna	B2
rohkelt	määrsõna	B2
rohkesti	määrsõna	B2
rohkus	nimisõna	B2
rokk	nimisõna	B2
roller	nimisõna	B2
romantika	nimisõna	B2
romantiline	omadussõna	B2
rongkäik	nimisõna	B2
ronimispuu	nimisõna	B2
roog	nimisõna	B2
roog	nimisõna	B2
roolima	tegusõna	B2
rooste	nimisõna	B2
roostetama	tegusõna	B2
ropendama	tegusõna	B2
ropp	omadussõna	B2
roppus	nimisõna	B2
rubriik	nimisõna	B2
rula	nimisõna	B2
rull	nimisõna	B2
rullima	tegusõna	B2
rulluisutama	tegusõna	B2
rumm	nimisõna	B2
rutiin	nimisõna	B2
rutiinne	omadussõna	B2
ruumiline	omadussõna	B2
rõhuma	tegusõna	B2
rõhutama	tegusõna	B2
rõivastus	nimisõna	B2
rõngas	nimisõna	B2
rõuged	nimisõna	B2
rõõmsameelne	omadussõna	B2
rõõmustav	omadussõna	B2
rähn	nimisõna	B2
rämps	nimisõna	B2
rämpstoit	nimisõna	B2
rändama	tegusõna	B2
rändur	nimisõna	B2
rängalt	määrsõna	B2
ränk	omadussõna	B2
rännak	nimisõna	B2
ränne	nimisõna	B2
räpane	omadussõna	B2
rästik	nimisõna	B2
rääkimata	määrsõna	B2
röntgen	nimisõna	B2
rööbas	nimisõna	B2
rööv	nimisõna	B2
rühmitus	nimisõna	B2
rüht	nimisõna	B2
rünne	nimisõna	B2
rüütel	nimisõna	B2
saadetis	nimisõna	B2
saaga	nimisõna	B2
saamatu	omadussõna	B2
saamatus	nimisõna	B2
saar	nimisõna	B2
saarestik	nimisõna	B2
saarlane	nimisõna	B2
saast	nimisõna	B2
saastama	tegusõna	B2
saastatus	nimisõna	B2
saastuma	tegusõna	B2
saatan	nimisõna	B2
saatejuht	nimisõna	B2
saatekava	nimisõna	B2
saatel	kaassõna	B2
saatesari	nimisõna	B2
saati	kaassõna	B2
saatuslik	omadussõna	B2
sademed	nimisõna	B2
sagedamini	määrsõna	B2
sagedane	omadussõna	B2
sagedasti	määrsõna	B2
sagenema	tegusõna	B2
sahtel	nimisõna	B2
sahver	nimisõna	B2
saialill	nimisõna	B2
sait	nimisõna	B2
sajajalgne	nimisõna	B2
salakaup	nimisõna	B2
salakaval	omadussõna	B2
salakeel	nimisõna	B2
salapärane	omadussõna	B2
salastama	tegusõna	B2
salaviin	nimisõna	B2
salk	nimisõna	B2
salk	nimisõna	B2
sallima	tegusõna	B2
sallimatus	nimisõna	B2
salliv	omadussõna	B2
sallivus	nimisõna	B2
salm	nimisõna	B2
salv	nimisõna	B2
salvestis	nimisõna	B2
salvestus	nimisõna	B2
samaaegselt	määrsõna	B2
samalaadne	omadussõna	B2
samapalju	määrsõna	B2
samasooline	omadussõna	B2
samastama	tegusõna	B2
samastuma	tegusõna	B2
samavõrd	määrsõna	B2
samaväärne	omadussõna	B2
samblik	nimisõna	B2
samet	nimisõna	B2
samm-sammult	määrsõna	B2
sammal	nimisõna	B2
sammas	nimisõna	B2
sammuma	tegusõna	B2
sanatoorium	nimisõna	B2
sang	nimisõna	B2
sanktsioon	nimisõna	B2
sarapuu	nimisõna	B2
sari	nimisõna	B2
sarnaselt	määrsõna	B2
sarnasus	nimisõna	B2
sassi	määrsõna	B2
sassis	omadussõna	B2
satelliit	nimisõna	B2
saunalava	nimisõna	B2
savi	nimisõna	B2
seadistus	nimisõna	B2
seadma	tegusõna	B2
seadusandlus	nimisõna	B2
seadusevastane	omadussõna	B2
seaduslikkus	nimisõna	B2
seaduspära	nimisõna	B2
seadustama	tegusõna	B2
sealjuures	määrsõna	B2
sealkandis	määrsõna	B2
sealpool	määrsõna	B2
sealpool	kaassõna	B2
sealsamas	määrsõna	B2
seanss	nimisõna	B2
sebra	nimisõna	B2
sedasi	määrsõna	B2
sedasorti	omadussõna	B2
sedavõrd	määrsõna	B2
sedel	nimisõna	B2
see-eest	määrsõna	B2
seebiooper	nimisõna	B2
seedima	tegusõna	B2
seejuures	määrsõna	B2
seejärel	määrsõna	B2
seeläbi	määrsõna	B2
seenhaigus	nimisõna	B2
seenior	nimisõna	B2
seepeale	määrsõna	B2
seesmine	omadussõna	B2
seesugune	asesõna	B2
seetõttu	määrsõna	B2
seevastu	määrsõna	B2
segamatult	määrsõna	B2
segu	nimisõna	B2
segunema	tegusõna	B2
seif	nimisõna	B2
seiklema	tegusõna	B2
seiklus	nimisõna	B2
seire	nimisõna	B2
seisukord	nimisõna	B2
seisus	nimisõna	B2
seitsmene	omadussõna	B2
sekeldus	nimisõna	B2
sekka	määrsõna	B2
sekka	kaassõna	B2
seksikas	omadussõna	B2
seksima	tegusõna	B2
sekt	nimisõna	B2
sektor	nimisõna	B2
sektsioon	nimisõna	B2
seletamatu	omadussõna	B2
seletuskiri	nimisõna	B2
selgeltnägija	nimisõna	B2
selgusetu	omadussõna	B2
seljataga	määrsõna	B2
seljataha	määrsõna	B2
sell	nimisõna	B2
sellegipoolest	määrsõna	B2
sellekohane	omadussõna	B2
selletõttu	määrsõna	B2
selliselt	määrsõna	B2
seltsiline	nimisõna	B2
seltsima	tegusõna	B2
seltsimatu	omadussõna	B2
seltsis	kaassõna	B2
seltsist	kaassõna	B2
seltsiv	omadussõna	B2
seltskondlik	omadussõna	B2
semester	nimisõna	B2
semikoolon	nimisõna	B2
semu	nimisõna	B2
senat	nimisõna	B2
seniks	määrsõna	B2
seonduma	tegusõna	B2
seostama	tegusõna	B2
seostuma	tegusõna	B2
seotus	nimisõna	B2
seriaal	nimisõna	B2
sertifikaat	nimisõna	B2
serv	nimisõna	B2
serveerima	tegusõna	B2
serviis	nimisõna	B2
sessioon	nimisõna	B2
sestap	sidesõna	B2
setu	nimisõna	B2
sfäär	nimisõna	B2
sidevahend	nimisõna	B2
sidur	nimisõna	B2
sidus	omadussõna	B2
sidusus	nimisõna	B2
siduv	omadussõna	B2
sigadus	nimisõna	B2
sigar	nimisõna	B2
signalisatsioon	nimisõna	B2
sihikindel	omadussõna	B2
sihikindlus	nimisõna	B2
sihipärane	omadussõna	B2
sihipäraselt	määrsõna	B2
sihtgrupp	nimisõna	B2
sihtima	tegusõna	B2
sihtotstarve	nimisõna	B2
sihtrühm	nimisõna	B2
sihvakas	omadussõna	B2
siiamaani	määrsõna	B2
siiapoole	määrsõna	B2
siider	nimisõna	B2
siinjuures	määrsõna	B2
siinkandis	määrsõna	B2
siinkohal	määrsõna	B2
siinmail	määrsõna	B2
siiralt	määrsõna	B2
siiras	omadussõna	B2
siirduma	tegusõna	B2
siitpoolt	määrsõna	B2
silinder	nimisõna	B2
silitama	tegusõna	B2
silm	nimisõna	B2
silmakirjalik	omadussõna	B2
silmakirjalikkus	nimisõna	B2
silmapiir	nimisõna	B2
silmaring	nimisõna	B2
silmitsi	määrsõna	B2
silmus	nimisõna	B2
silp	nimisõna	B2
siluma	tegusõna	B2
sinatama	tegusõna	B2
sinikas	nimisõna	B2
sinimustvalge	omadussõna	B2
sinnapoole	määrsõna	B2
sirkel	nimisõna	B2
sirutama	tegusõna	B2
sirvima	tegusõna	B2
sisalduma	tegusõna	B2
sisaldus	nimisõna	B2
sisekujundus	nimisõna	B2
sisemiselt	määrsõna	B2
sisemus	nimisõna	B2
sisend	nimisõna	B2
sisendama	tegusõna	B2
sisene	omadussõna	B2
sisepoliitika	nimisõna	B2
sisepoliitiline	omadussõna	B2
sisetunne	nimisõna	B2
sissejuhatus	nimisõna	B2
sissekirjutus	nimisõna	B2
sissemakse	nimisõna	B2
sisseost	nimisõna	B2
sisseränne	nimisõna	B2
sissetung	nimisõna	B2
sissetungija	nimisõna	B2
sisukas	omadussõna	B2
sisuline	omadussõna	B2
sisuliselt	määrsõna	B2
sisustama	tegusõna	B2
sisustus	nimisõna	B2
skaala	nimisõna	B2
skandaalne	omadussõna	B2
skanner	nimisõna	B2
skelett	nimisõna	B2
skepsis	nimisõna	B2
skeptik	nimisõna	B2
skeptiline	omadussõna	B2
skulptuur	nimisõna	B2
slaid	nimisõna	B2
sobilik	omadussõna	B2
sobimatu	omadussõna	B2
sobitama	tegusõna	B2
sobituma	tegusõna	B2
sobivus	nimisõna	B2
sodi	nimisõna	B2
sodima	tegusõna	B2
soetama	tegusõna	B2
soine	omadussõna	B2
sokkel	nimisõna	B2
solaarium	nimisõna	B2
soldat	nimisõna	B2
solidaarsus	nimisõna	B2
soliidne	omadussõna	B2
solist	nimisõna	B2
solvang	nimisõna	B2
soodsalt	määrsõna	B2
soodus	omadussõna	B2
soodustama	tegusõna	B2
soodustamine	nimisõna	B2
soojalt	määrsõna	B2
soojendama	tegusõna	B2
soojendus	nimisõna	B2
soojenema	tegusõna	B2
soojus	nimisõna	B2
soojustama	tegusõna	B2
soojustus	nimisõna	B2
sool	nimisõna	B2
soolatoos	nimisõna	B2
soolatops	nimisõna	B2
soolestik	nimisõna	B2
sooline	omadussõna	B2
soolo	nimisõna	B2
soome-ugri	käändumatu omadussõna	B2
soomuk	nimisõna	B2
sooritus	nimisõna	B2
soosik	nimisõna	B2
soosima	tegusõna	B2
sooviavaldus	nimisõna	B2
soovimatu	omadussõna	B2
soovitatav	omadussõna	B2
soovitav	omadussõna	B2
soovitavalt	määrsõna	B2
soovituslik	omadussõna	B2
sopp	nimisõna	B2
sorteerima	tegusõna	B2
sortiment	nimisõna	B2
sosistama	tegusõna	B2
sotsiaalmaks	nimisõna	B2
sotsiaalmeedia	nimisõna	B2
sotsialism	nimisõna	B2
sotsioloog	nimisõna	B2
sotsioloogia	nimisõna	B2
sotsioloogiline	omadussõna	B2
spekulatsioon	nimisõna	B2
spekuleerima	tegusõna	B2
sperma	nimisõna	B2
spetsiaalselt	määrsõna	B2
spetsialiseeruma	tegusõna	B2
spetsiifika	nimisõna	B2
spetsiifiline	omadussõna	B2
spidomeeter	nimisõna	B2
spiiker	nimisõna	B2
spikerdama	tegusõna	B2
spikker	nimisõna	B2
spinat	nimisõna	B2
spioon	nimisõna	B2
spiraal	nimisõna	B2
sponsorlus	nimisõna	B2
spontaanne	omadussõna	B2
sportima	tegusõna	B2
staadium	nimisõna	B2
staap	nimisõna	B2
staar	nimisõna	B2
staaž	nimisõna	B2
staažikas	omadussõna	B2
staatiline	omadussõna	B2
staatus	nimisõna	B2
stabiliseerima	tegusõna	B2
stabiliseeruma	tegusõna	B2
standard	nimisõna	B2
standardne	omadussõna	B2
stažeerima	tegusõna	B2
statistiline	omadussõna	B2
statistiliselt	määrsõna	B2
statsionaarne	omadussõna	B2
statuut	nimisõna	B2
stend	nimisõna	B2
stereotüüp	nimisõna	B2
stiilne	omadussõna	B2
stiimul	nimisõna	B2
stimuleerima	tegusõna	B2
stipp	nimisõna	B2
strateegia	nimisõna	B2
strateegiline	omadussõna	B2
strateegiliselt	määrsõna	B2
streikima	tegusõna	B2
struktureerima	tegusõna	B2
stseen	nimisõna	B2
stsenaarium	nimisõna	B2
stsenarist	nimisõna	B2
stuudio	nimisõna	B2
subjekt	nimisõna	B2
subjektiivne	omadussõna	B2
sudoku	nimisõna	B2
sugugi	määrsõna	B2
suguhaigus	nimisõna	B2
suguharu	nimisõna	B2
suguline	omadussõna	B2
sugulus	nimisõna	B2
sugupuu	nimisõna	B2
suguvõsa	nimisõna	B2
suhkruhaigus	nimisõna	B2
suhkrutoos	nimisõna	B2
suht	määrsõna	B2
suhtekorraldaja	nimisõna	B2
suhtleja	nimisõna	B2
suhtlemisoskus	nimisõna	B2
suhtlemisvalmis	omadussõna	B2
suitsema	tegusõna	B2
sujuma	tegusõna	B2
sujuv	omadussõna	B2
sujuvalt	määrsõna	B2
sukelduma	tegusõna	B2
sula	nimisõna	B2
sulanduma	tegusõna	B2
sulane	nimisõna	B2
sulg	nimisõna	B2
sulguma	tegusõna	B2
suli	nimisõna	B2
sunnil	kaassõna	B2
supelrand	nimisõna	B2
suplema	tegusõna	B2
surematu	omadussõna	B2
suremus	nimisõna	B2
suretama	tegusõna	B2
surfama	tegusõna	B2
surmama	tegusõna	B2
surmanuhtlus	nimisõna	B2
surnuaed	nimisõna	B2
suruma	tegusõna	B2
surve	nimisõna	B2
survestama	tegusõna	B2
suuliselt	määrsõna	B2
suunduma	tegusõna	B2
suundumus	nimisõna	B2
suunis	nimisõna	B2
suunitlus	nimisõna	B2
suupiste	nimisõna	B2
suurejooneline	omadussõna	B2
suurelt	määrsõna	B2
suuremeelne	omadussõna	B2
suuresti	määrsõna	B2
suurkuju	nimisõna	B2
suursaadik	nimisõna	B2
suurtükk	nimisõna	B2
suurusjärk	nimisõna	B2
suuteline	omadussõna	B2
suutlikkus	nimisõna	B2
suutmatus	nimisõna	B2
suva	nimisõna	B2
suvaline	omadussõna	B2
suvaliselt	määrsõna	B2
suveräänne	omadussõna	B2
suveräänsus	nimisõna	B2
suvitama	tegusõna	B2
svamm	nimisõna	B2
sviit	nimisõna	B2
sõbratar	nimisõna	B2
sõdalane	nimisõna	B2
sõdima	tegusõna	B2
sõel	nimisõna	B2
sõeluma	tegusõna	B2
sõeluuring	nimisõna	B2
sõim	nimisõna	B2
sõim	nimisõna	B2
sõimama	tegusõna	B2
sõjakas	omadussõna	B2
sõjaväelane	nimisõna	B2
sõltlane	nimisõna	B2
sõltumatus	nimisõna	B2
sõnakas	omadussõna	B2
sõnaliik	nimisõna	B2
sõnama	tegusõna	B2
sõnastama	tegusõna	B2
sõnastus	nimisõna	B2
sõnavõtt	nimisõna	B2
sõnaõigus	nimisõna	B2
sõnnik	nimisõna	B2
sõnutsi	määrsõna	B2
sõpruskond	nimisõna	B2
sõrmik	nimisõna	B2
sõrmus	nimisõna	B2
sõudma	tegusõna	B2
säde	nimisõna	B2
sädelema	tegusõna	B2
säilitusaine	nimisõna	B2
säilmed	nimisõna	B2
sära	nimisõna	B2
särama	tegusõna	B2
särav	omadussõna	B2
säravalt	määrsõna	B2
särtsakas	omadussõna	B2
säte	nimisõna	B2
sättima	tegusõna	B2
säärane	asesõna	B2
sääst	nimisõna	B2
säästlik	omadussõna	B2
säästmine	nimisõna	B2
säästurežiim	nimisõna	B2
söödav	omadussõna	B2
sööt	nimisõna	B2
südamelähedane	omadussõna	B2
südametunnistus	nimisõna	B2
südamik	nimisõna	B2
sügama	tegusõna	B2
sügaval	määrsõna	B2
sügavale	määrsõna	B2
sügavuti	määrsõna	B2
sügelus	nimisõna	B2
sülg	nimisõna	B2
süli	nimisõna	B2
sümboliseerima	tegusõna	B2
sümboolika	nimisõna	B2
sümboolne	omadussõna	B2
sümfoonia	nimisõna	B2
sümpaatia	nimisõna	B2
sümpaatne	omadussõna	B2
sümptom	nimisõna	B2
sündimus	nimisõna	B2
sündmuskoht	nimisõna	B2
sündmustik	nimisõna	B2
sündroom	nimisõna	B2
sünergia	nimisõna	B2
sünge	omadussõna	B2
sünnipaik	nimisõna	B2
sünnipärane	omadussõna	B2
sünnitus	nimisõna	B2
sünonüüm	nimisõna	B2
süntees	nimisõna	B2
sünteesima	tegusõna	B2
sünteetiline	omadussõna	B2
süsi	nimisõna	B2
süsivesik	nimisõna	B2
süstal	nimisõna	B2
süsteemne	omadussõna	B2
süstemaatiline	omadussõna	B2
süstematiseerima	tegusõna	B2
süstima	tegusõna	B2
süžee	nimisõna	B2
süvendama	tegusõna	B2
süvenema	tegusõna	B2
süvenev	omadussõna	B2
süvitsi	määrsõna	B2
süüdimatu	omadussõna	B2
süüdlane	nimisõna	B2
süütegu	nimisõna	B2
süütu	omadussõna	B2
süütunne	nimisõna	B2
süütus	nimisõna	B2
šabloon	nimisõna	B2
šanss	nimisõna	B2
šokeerima	tegusõna	B2
šõu	nimisõna	B2
žanr	nimisõna	B2
žest	nimisõna	B2
taandama	tegusõna	B2
taanduma	tegusõna	B2
taane	nimisõna	B2
taarapunkt	nimisõna	B2
taasiseseisvuma	tegusõna	B2
taaskasutama	tegusõna	B2
taaskasutus	nimisõna	B2
taaskord	määrsõna	B2
taastama	tegusõna	B2
taastuma	tegusõna	B2
taastumatu	omadussõna	B2
taastuvenergia	nimisõna	B2
tabama	tegusõna	B2
tabamus	nimisõna	B2
tabav	omadussõna	B2
tabloo	nimisõna	B2
tabu	nimisõna	B2
taevakeha	nimisõna	B2
taevane	omadussõna	B2
taga ajama	tegusõna	B2
tagala	nimisõna	B2
tagama	tegusõna	B2
taganema	tegusõna	B2
tagantjärele	määrsõna	B2
tagantjärgi	määrsõna	B2
tagaotsitav	omadussõna	B2
tagaplaanil	määrsõna	B2
tagaplaanile	määrsõna	B2
tagapõhi	nimisõna	B2
tagasi lükkama	tegusõna	B2
tagasihoidlikkus	nimisõna	B2
tagasilöök	nimisõna	B2
tagasimakse	nimisõna	B2
tagasiside	nimisõna	B2
tagasitulek	nimisõna	B2
taguma	tegusõna	B2
tagumine	omadussõna	B2
tagune	omadussõna	B2
tagurdama	tegusõna	B2
tahk	nimisõna	B2
tahm	nimisõna	B2
tahtejõud	nimisõna	B2
tahtejõuetu	omadussõna	B2
tahtejõuline	omadussõna	B2
tahtlik	omadussõna	B2
tahtlikult	määrsõna	B2
tahtmatu	omadussõna	B2
tahtmatult	määrsõna	B2
taimetoit	nimisõna	B2
taimetoitlane	nimisõna	B2
taimne	omadussõna	B2
taipama	tegusõna	B2
taju	nimisõna	B2
takerduma	tegusõna	B2
taks	nimisõna	B2
taks (kindel hind)	nimisõna	B2
takt	nimisõna	B2
taktikaline	omadussõna	B2
taktitu	omadussõna	B2
talent	nimisõna	B2
talgud	nimisõna	B2
talitus	nimisõna	B2
tall	nimisõna	B2
tall	nimisõna	B2
taluma	tegusõna	B2
tammetõru	nimisõna	B2
tandem	nimisõna	B2
tang	nimisõna	B2
tank	nimisõna	B2
tanker	nimisõna	B2
tankima	tegusõna	B2
tankla	nimisõna	B2
taoline	omadussõna	B2
taotlusvoor	nimisõna	B2
tappev	omadussõna	B2
tara	nimisõna	B2
tarbeasi	nimisõna	B2
tarbeese	nimisõna	B2
tarbekaup	nimisõna	B2
tarbekunst	nimisõna	B2
tarbetekst	nimisõna	B2
tarbetu	omadussõna	B2
tarbija	nimisõna	B2
targutama	tegusõna	B2
tariif	nimisõna	B2
taristu	nimisõna	B2
tark	nimisõna	B2
tarkvara	nimisõna	B2
tarnima	tegusõna	B2
tarretis	nimisõna	B2
taru	nimisõna	B2
tarve	nimisõna	B2
tarvilik	omadussõna	B2
tarvitama	tegusõna	B2
tarvitsema	tegusõna	B2
tasakaalukas	omadussõna	B2
tasakaalustama	tegusõna	B2
tasandama	tegusõna	B2
tasapisi	määrsõna	B2
taskukohane	omadussõna	B2
tassima	tegusõna	B2
tasustama	tegusõna	B2
tasuv	omadussõna	B2
tatt	nimisõna	B2
taunima	tegusõna	B2
tavapäraselt	määrsõna	B2
tavatsema	tegusõna	B2
teabepäev	nimisõna	B2
teadaanne	nimisõna	B2
teadagi	määrsõna	B2
teadaolev	omadussõna	B2
teadaolevalt	määrsõna	B2
teadlikkus	nimisõna	B2
teadmata	omadussõna	B2
teadmatus	nimisõna	B2
teadmishimuline	omadussõna	B2
teadupärast	määrsõna	B2
teadur	nimisõna	B2
teaduskond	nimisõna	B2
teaduslikult	määrsõna	B2
teadvustama	tegusõna	B2
teatavasti	määrsõna	B2
teatejooks	nimisõna	B2
teatis	nimisõna	B2
teatmeteos	nimisõna	B2
teemant	nimisõna	B2
teene	nimisõna	B2
teenekas	omadussõna	B2
teener	nimisõna	B2
teenetemärk	nimisõna	B2
teenija	nimisõna	B2
teenistus	nimisõna	B2
tees	nimisõna	B2
teeviit	nimisõna	B2
tegelaskuju	nimisõna	B2
tegevusetus	nimisõna	B2
tegevuskoht	nimisõna	B2
tegumood	nimisõna	B2
tegur	nimisõna	B2
tegus	omadussõna	B2
teguviis	nimisõna	B2
tehing	nimisõna	B2
tehniliselt	määrsõna	B2
teietama	tegusõna	B2
teinekord	määrsõna	B2
teisalt	määrsõna	B2
teisene	omadussõna	B2
teisisõnu	määrsõna	B2
teispool	kaassõna	B2
teispoole	kaassõna	B2
teistkordne	omadussõna	B2
teistkordselt	määrsõna	B2
teistpidi	määrsõna	B2
teivas	nimisõna	B2
teke	nimisõna	B2
tekk	nimisõna	B2
tekkepõhjus	nimisõna	B2
tekstiil	nimisõna	B2
tekstuur	nimisõna	B2
telefonitsi	määrsõna	B2
teleskoop	nimisõna	B2
televisioon	nimisõna	B2
telg	nimisõna	B2
telk	nimisõna	B2
teller	nimisõna	B2
tellis	nimisõna	B2
telliskivi	nimisõna	B2
temaatika	nimisõna	B2
temaatiline	omadussõna	B2
tempel	nimisõna	B2
tempel	nimisõna	B2
temperament	nimisõna	B2
temperamentne	omadussõna	B2
tempokas	omadussõna	B2
tendents	nimisõna	B2
teoks saama	tegusõna	B2
teoks tegema	tegusõna	B2
teoloogia	nimisõna	B2
teooria	nimisõna	B2
teoreetik	nimisõna	B2
teoreetiline	omadussõna	B2
teoreetiliselt	määrsõna	B2
teostama	tegusõna	B2
teostamatu	omadussõna	B2
teostuma	tegusõna	B2
teraapia	nimisõna	B2
terapeut	nimisõna	B2
teras	nimisõna	B2
teraselt	määrsõna	B2
teravalt	määrsõna	B2
teravdama	tegusõna	B2
teravili	nimisõna	B2
teravus	nimisõna	B2
teretulnud	omadussõna	B2
teritaja	nimisõna	B2
termin	nimisõna	B2
terminoloogia	nimisõna	B2
termomeeter	nimisõna	B2
terrass	nimisõna	B2
territoriaalne	omadussõna	B2
terror	nimisõna	B2
terroriakt	nimisõna	B2
terrorism	nimisõna	B2
terrorist	nimisõna	B2
tervendama	tegusõna	B2
tervenema	tegusõna	B2
tervik	nimisõna	B2
terviklik	omadussõna	B2
terviklikkus	nimisõna	B2
tervisepäev	nimisõna	B2
tervishoid	nimisõna	B2
tervislikult	määrsõna	B2
testament	nimisõna	B2
tihedus	nimisõna	B2
tihendama	tegusõna	B2
tihenema	tegusõna	B2
tihtilugu	määrsõna	B2
tihtipeale	määrsõna	B2
tiik	nimisõna	B2
tiim	nimisõna	B2
tiir	nimisõna	B2
tiirlema	tegusõna	B2
tiirutama	tegusõna	B2
tikker	nimisõna	B2
tikkima	tegusõna	B2
tilk	nimisõna	B2
tilkuma	tegusõna	B2
tilluke	omadussõna	B2
tina	nimisõna	B2
tingima	tegusõna	B2
tingimata	määrsõna	B2
tingimisi	määrsõna	B2
tinglik	omadussõna	B2
tinglikult	määrsõna	B2
tingmärk	nimisõna	B2
tint	nimisõna	B2
tipnema	tegusõna	B2
tipp	nimisõna	B2
tippima	tegusõna	B2
tippkohtumine	nimisõna	B2
tiraaž	nimisõna	B2
tirima	tegusõna	B2
tisler	nimisõna	B2
tita	nimisõna	B2
titt	nimisõna	B2
tituleerima	tegusõna	B2
tobe	omadussõna	B2
toekas	omadussõna	B2
toel	kaassõna	B2
toetav	omadussõna	B2
toetuma	tegusõna	B2
tohter	nimisõna	B2
tohutu	määrsõna	B2
tohutult	määrsõna	B2
toidulisand	nimisõna	B2
toime	nimisõna	B2
toime panema	tegusõna	B2
toimeaine	nimisõna	B2
toimetulek	nimisõna	B2
toimetus	nimisõna	B2
toimima	tegusõna	B2
toiming	nimisõna	B2
toimkond	nimisõna	B2
toimumiskoht	nimisõna	B2
toimunu	nimisõna	B2
toitaine	nimisõna	B2
toitlustama	tegusõna	B2
toitlustus	nimisõna	B2
toksiline	omadussõna	B2
toksima	tegusõna	B2
tolerantne	omadussõna	B2
tolerantsus	nimisõna	B2
tollal	määrsõna	B2
tollane	omadussõna	B2
tolleaegne	omadussõna	B2
tollimaks	nimisõna	B2
tont	nimisõna	B2
too	asesõna	B2
toodang	nimisõna	B2
tookord	määrsõna	B2
toona	määrsõna	B2
toonane	omadussõna	B2
toonekurg	nimisõna	B2
toonitama	tegusõna	B2
toonus	nimisõna	B2
tooraine	nimisõna	B2
tootlikkus	nimisõna	B2
topelt	määrsõna	B2
topp	nimisõna	B2
toppima	tegusõna	B2
tops	nimisõna	B2
torge	nimisõna	B2
torkima	tegusõna	B2
tormama	tegusõna	B2
torupill	nimisõna	B2
toss (paks suits)	nimisõna	B2
totaalne	omadussõna	B2
traagika	nimisõna	B2
traagiline	omadussõna	B2
traat	nimisõna	B2
trahvima	tegusõna	B2
trajektoor	nimisõna	B2
transportima	tegusõna	B2
trass	nimisõna	B2
trauma	nimisõna	B2
treenima	tegusõna	B2
treiler	nimisõna	B2
trell	nimisõna	B2
trend	nimisõna	B2
trendikas	omadussõna	B2
tribunal	nimisõna	B2
tribüün	nimisõna	B2
trikotaaž	nimisõna	B2
triljon	põhiarvsõna	B2
trio	nimisõna	B2
triumf	nimisõna	B2
troll	nimisõna	B2
tromboon	nimisõna	B2
troon	nimisõna	B2
troopiline	omadussõna	B2
tross	nimisõna	B2
trukk	nimisõna	B2
trupp	nimisõna	B2
truudus	nimisõna	B2
trükikoda	nimisõna	B2
trükis	nimisõna	B2
trükitäht	nimisõna	B2
trükk	nimisõna	B2
tsaar	nimisõna	B2
tsenseerima	tegusõna	B2
tsensuur	nimisõna	B2
tsenter	nimisõna	B2
tseremoonia	nimisõna	B2
tsikkel	nimisõna	B2
tsitaat	nimisõna	B2
tsiteerima	tegusõna	B2
tsivilisatsioon	nimisõna	B2
tsiviliseerima	tegusõna	B2
tsoon	nimisõna	B2
tsükkel	nimisõna	B2
tsüklon	nimisõna	B2
tšekk	nimisõna	B2
tualettvesi	nimisõna	B2
tubakas	nimisõna	B2
tuberkuloos	nimisõna	B2
tugiisik	nimisõna	B2
tuginema	tegusõna	B2
tuhatkond	nimisõna	B2
tuhatoos	nimisõna	B2
tuhk	nimisõna	B2
tuhm	omadussõna	B2
tuhnima	tegusõna	B2
tuim	omadussõna	B2
tuimestus	nimisõna	B2
tuiskama	tegusõna	B2
tujukas	omadussõna	B2
tujukus	nimisõna	B2
tukk	nimisõna	B2
tulekindel	omadussõna	B2
tulem	nimisõna	B2
tulemuslik	omadussõna	B2
tulemuslikkus	nimisõna	B2
tulemüür	nimisõna	B2
tulenema	tegusõna	B2
tulenevalt	määrsõna	B2
tuletama	tegusõna	B2
tulnukas	nimisõna	B2
tuludeklaratsioon	nimisõna	B2
tulutu	omadussõna	B2
tulutult	määrsõna	B2
tumm	omadussõna	B2
tundlikkus	nimisõna	B2
tundma õppima	tegusõna	B2
tung	nimisõna	B2
tungivalt	määrsõna	B2
tunnetus	nimisõna	B2
tunnine	omadussõna	B2
tunniplaan	nimisõna	B2
tunnusjoon	nimisõna	B2
tunnustatus	nimisõna	B2
tuntus	nimisõna	B2
tupp	nimisõna	B2
turgutama	tegusõna	B2
turnee	nimisõna	B2
turnima	tegusõna	B2
turse	nimisõna	B2
turundus	nimisõna	B2
turustama	tegusõna	B2
turvakodu	nimisõna	B2
turvakontroll	nimisõna	B2
turvapadi	nimisõna	B2
turvatunne	nimisõna	B2
tuulelipp	nimisõna	B2
tuulepark	nimisõna	B2
tuuletõmme	nimisõna	B2
tuulik	nimisõna	B2
tuum	nimisõna	B2
tuumaelektrijaam	nimisõna	B2
tuumaenergia	nimisõna	B2
tuumajaam	nimisõna	B2
tuumarelv	nimisõna	B2
tuupima	tegusõna	B2
tuvastama	tegusõna	B2
tuvastamata	omadussõna	B2
tõbi	nimisõna	B2
tõdema	tegusõna	B2
tõdemus	nimisõna	B2
tõekspidamine	nimisõna	B2
tõendama	tegusõna	B2
tõenäosus	nimisõna	B2
tõepärane	omadussõna	B2
tõestama	tegusõna	B2
tõestus	nimisõna	B2
tõhus	omadussõna	B2
tõhustama	tegusõna	B2
tõhusus	nimisõna	B2
tõke	nimisõna	B2
tõkestama	tegusõna	B2
tõkkepuu	nimisõna	B2
tõlgendama	tegusõna	B2
tõlgendus	nimisõna	B2
tõmbuma	tegusõna	B2
tõmmu	omadussõna	B2
tõotama	tegusõna	B2
tõrge	nimisõna	B2
tõrje	nimisõna	B2
tõrjevahend	nimisõna	B2
tõrjuma	tegusõna	B2
tõrv	nimisõna	B2
tõrvik	nimisõna	B2
tõsiasi	nimisõna	B2
tõsidus	nimisõna	B2
tõsiseltvõetav	omadussõna	B2
tõstatama	tegusõna	B2
tõstuk	nimisõna	B2
tõtt-öelda	määrsõna	B2
tõug	nimisõna	B2
tõukama	tegusõna	B2
tõukeratas	nimisõna	B2
tõuks	nimisõna	B2
täheldama	tegusõna	B2
tähelepanek	nimisõna	B2
tähelepanuvõime	nimisõna	B2
tähelepanuväärne	omadussõna	B2
tähenduslik	omadussõna	B2
tähis	nimisõna	B2
tähistus	nimisõna	B2
tähtajatu	omadussõna	B2
tähtsusetu	omadussõna	B2
tähtsustama	tegusõna	B2
tähtsündmus	nimisõna	B2
täi	nimisõna	B2
täidis	nimisõna	B2
täidlane	omadussõna	B2
täiendama	tegusõna	B2
täiendavalt	määrsõna	B2
täiendus	nimisõna	B2
täiendõpe	nimisõna	B2
täienema	tegusõna	B2
täisealine	omadussõna	B2
täisväärtuslik	omadussõna	B2
täitsa	määrsõna	B2
täituma	tegusõna	B2
täiuslik	omadussõna	B2
täiustama	tegusõna	B2
tänaseks	määrsõna	B2
tänaseni	määrsõna	B2
tänavu	määrsõna	B2
tänukiri	nimisõna	B2
tänulikkus	nimisõna	B2
tänusõnad	nimisõna	B2
tänuväärne	omadussõna	B2
täpsustus	nimisõna	B2
tärkama	tegusõna	B2
tärklis	nimisõna	B2
tärn	nimisõna	B2
tätoveering	nimisõna	B2
töine	omadussõna	B2
töökindel	omadussõna	B2
töökoda	nimisõna	B2
töökohustus	nimisõna	B2
töökord	nimisõna	B2
töökus	nimisõna	B2
tööotsija	nimisõna	B2
tööpuudus	nimisõna	B2
tööstuslik	omadussõna	B2
töötlus	nimisõna	B2
töötuba	nimisõna	B2
töötukassa	nimisõna	B2
töövõime	nimisõna	B2
töövõimetus	nimisõna	B2
tüdima	tegusõna	B2
tüdinema	tegusõna	B2
tühi-tähi	nimisõna	B2
tühik	nimisõna	B2
tühine	omadussõna	B2
tühjalt	määrsõna	B2
tühjendama	tegusõna	B2
tühjus	nimisõna	B2
tükeldama	tegusõna	B2
tülikas	omadussõna	B2
tünn	nimisõna	B2
tüse	omadussõna	B2
tüsistus	nimisõna	B2
tüvi	nimisõna	B2
tüütu	omadussõna	B2
uduvihm	nimisõna	B2
uhkus	nimisõna	B2
uhkustama	tegusõna	B2
uimane	omadussõna	B2
uimasti	nimisõna	B2
uimasus	nimisõna	B2
uinak	nimisõna	B2
uinuma	tegusõna	B2
ujutama	tegusõna	B2
ulatama	tegusõna	B2
ulatuma	tegusõna	B2
ulatus	nimisõna	B2
ulatuslik	omadussõna	B2
ulatuslikult	määrsõna	B2
ulme	nimisõna	B2
ulmeline	omadussõna	B2
ultraheli	nimisõna	B2
uluk	nimisõna	B2
umbes	määrsõna	B2
umbkaudu	määrsõna	B2
umbrohi	nimisõna	B2
umbusaldamine	nimisõna	B2
umbusaldus	nimisõna	B2
ummistama	tegusõna	B2
ummistus	nimisõna	B2
unelm	nimisõna	B2
unerohi	nimisõna	B2
unetus	nimisõna	B2
unikaalne	omadussõna	B2
universaalne	omadussõna	B2
universum	nimisõna	B2
ununema	tegusõna	B2
unustamatu	omadussõna	B2
uputama	tegusõna	B2
uputus	nimisõna	B2
uriin	nimisõna	B2
usaldamatus	nimisõna	B2
usaldus	nimisõna	B2
usaldusisik	nimisõna	B2
usaldusväärne	omadussõna	B2
usaldusväärsus	nimisõna	B2
usin	omadussõna	B2
usinalt	määrsõna	B2
uskumatult	määrsõna	B2
uskumus	nimisõna	B2
ustav	omadussõna	B2
usuline	omadussõna	B2
usund	nimisõna	B2
usutavasti	määrsõna	B2
usuteadus	nimisõna	B2
usutlus	nimisõna	B2
usutunnistus	nimisõna	B2
usuvabadus	nimisõna	B2
utoopia	nimisõna	B2
uudishimu	nimisõna	B2
uudishimulik	omadussõna	B2
uudistama	tegusõna	B2
uudne	omadussõna	B2
uudsus	nimisõna	B2
uuendama	tegusõna	B2
uuendus	nimisõna	B2
uuenduslik	omadussõna	B2
uuendusmeelne	omadussõna	B2
uuenema	tegusõna	B2
uurija	nimisõna	B2
uurimistöö	nimisõna	B2
uusaeg	nimisõna	B2
uuskasutus	nimisõna	B2
vaablane	nimisõna	B2
vaakum	nimisõna	B2
vaas	nimisõna	B2
vaatemäng	nimisõna	B2
vaatenurk	nimisõna	B2
vaatepilt	nimisõna	B2
vaatepunkt	nimisõna	B2
vaatlema	tegusõna	B2
vaatlus	nimisõna	B2
vaatus	nimisõna	B2
vabadusvõitlus	nimisõna	B2
vabakutseline	omadussõna	B2
vabameelne	omadussõna	B2
vaegnägija	nimisõna	B2
vaen	nimisõna	B2
vaenulik	omadussõna	B2
vaevaline	omadussõna	B2
vaevaliselt	määrsõna	B2
vaevama	tegusõna	B2
vaevlema	tegusõna	B2
vaevu	määrsõna	B2
vaevuma	tegusõna	B2
vaevus	nimisõna	B2
vaha	nimisõna	B2
vahelduma	tegusõna	B2
vaheldumisi	määrsõna	B2
vaheldus	nimisõna	B2
vahelt	määrsõna	B2
vahelt	kaassõna	B2
vahemik	nimisõna	B2
vahendama	tegusõna	B2
vahendus	nimisõna	B2
vahepala	nimisõna	B2
vahepealne	omadussõna	B2
vaherahu	nimisõna	B2
vahest	määrsõna	B2
vahetevahel	määrsõna	B2
vahetu	omadussõna	B2
vahetult	määrsõna	B2
vahetuma	tegusõna	B2
vahetus	nimisõna	B2
vahistama	tegusõna	B2
vaht	nimisõna	B2
vahtima	tegusõna	B2
vahustama	tegusõna	B2
vahuvein	nimisõna	B2
vai	nimisõna	B2
vaidlustama	tegusõna	B2
vaieldamatult	määrsõna	B2
vaieldav	omadussõna	B2
vaik	nimisõna	B2
vaimselt	määrsõna	B2
vaimsus	nimisõna	B2
vaimuhaige	nimisõna	B2
vaimulik	nimisõna	B2
vaimulik	omadussõna	B2
vaimustama	tegusõna	B2
vaimustuma	tegusõna	B2
vaimustus	nimisõna	B2
vaist	nimisõna	B2
vajaminev	omadussõna	B2
vajuma	tegusõna	B2
valdavalt	määrsõna	B2
valdus	nimisõna	B2
valeandmed	nimisõna	B2
valem	nimisõna	B2
valgustama	tegusõna	B2
valgusti	nimisõna	B2
valgustus	nimisõna	B2
vali	omadussõna	B2
valim	nimisõna	B2
valimisjaoskond	nimisõna	B2
valimisõigus	nimisõna	B2
valitseja	nimisõna	B2
valk	nimisõna	B2
vall	nimisõna	B2
vallandama	tegusõna	B2
vallavalitsus	nimisõna	B2
vallavanem	nimisõna	B2
vallutama	tegusõna	B2
valmidus	nimisõna	B2
valmisolek	nimisõna	B2
valmistoit	nimisõna	B2
valulik	omadussõna	B2
valutu	omadussõna	B2
valuvaigisti	nimisõna	B2
vampiir	nimisõna	B2
vanaaeg	nimisõna	B2
vanaaegne	omadussõna	B2
vanadekodu	nimisõna	B2
vanadus	nimisõna	B2
vananema	tegusõna	B2
vanaonu	nimisõna	B2
vanasõna	nimisõna	B2
vanatädi	nimisõna	B2
vandenõu	nimisõna	B2
vanduma	tegusõna	B2
vanemaealine	omadussõna	B2
vanemahüvitis	nimisõna	B2
vanemlik	omadussõna	B2
vangistama	tegusõna	B2
vangistus	nimisõna	B2
vanilje	nimisõna	B2
vanill	nimisõna	B2
vanne	nimisõna	B2
vannitama	tegusõna	B2
vanur	nimisõna	B2
vanusegrupp	nimisõna	B2
vapp	nimisõna	B2
vapper	omadussõna	B2
vapralt	määrsõna	B2
vaprus	nimisõna	B2
vapsik	nimisõna	B2
vapustama	tegusõna	B2
vapustav	omadussõna	B2
vapustus	nimisõna	B2
varakult	määrsõna	B2
varaline	omadussõna	B2
varandus	nimisõna	B2
varasemalt	määrsõna	B2
variatsioon	nimisõna	B2
varieeruma	tegusõna	B2
varisema	tegusõna	B2
varitsema	tegusõna	B2
varjama	tegusõna	B2
varjuma	tegusõna	B2
varjund	nimisõna	B2
varjunimi	nimisõna	B2
varjupaik	nimisõna	B2
varjutama	tegusõna	B2
varras	nimisõna	B2
varrukas	nimisõna	B2
varss	nimisõna	B2
varu	nimisõna	B2
varuma	tegusõna	B2
varustama	tegusõna	B2
vasakpoolne	omadussõna	B2
vasakule	määrsõna	B2
vasakult	määrsõna	B2
vask	nimisõna	B2
vast	määrsõna	B2
vastaja	nimisõna	B2
vastamisi	määrsõna	B2
vastand	nimisõna	B2
vastandama	tegusõna	B2
vastandlik	omadussõna	B2
vastanduma	tegusõna	B2
vastaspool	nimisõna	B2
vastasseis	nimisõna	B2
vastast	kaassõna	B2
vastastikku	määrsõna	B2
vastastikune	omadussõna	B2
vastavalt	määrsõna	B2
vastavalt	kaassõna	B2
vastavus	nimisõna	B2
vaste	nimisõna	B2
vastsündinu	nimisõna	B2
vastuargument	nimisõna	B2
vastukaja	nimisõna	B2
vastumeelne	omadussõna	B2
vastumeelsus	nimisõna	B2
vastuolu	nimisõna	B2
vastuoluline	omadussõna	B2
vastupanu	nimisõna	B2
vastupidavus	nimisõna	B2
vastupidine	omadussõna	B2
vastupidiselt	määrsõna	B2
vasturääkiv	omadussõna	B2
vastuseis	nimisõna	B2
vastutulelik	omadussõna	B2
vastutus	nimisõna	B2
vastutustundetu	omadussõna	B2
vastutustundlik	omadussõna	B2
vastutustunne	nimisõna	B2
vastuvõetamatu	omadussõna	B2
vastuvõetav	omadussõna	B2
vastuvõtlik	omadussõna	B2
vastuväide	nimisõna	B2
veatu	omadussõna	B2
vedelema	tegusõna	B2
vedelik	nimisõna	B2
vedru	nimisõna	B2
vedu	nimisõna	B2
vedur	nimisõna	B2
veebipõhine	omadussõna	B2
veekindel	omadussõna	B2
veen	nimisõna	B2
veenduma	tegusõna	B2
veendumus	nimisõna	B2
veendunud	omadussõna	B2
veenev	omadussõna	B2
veenma	tegusõna	B2
veenvalt	määrsõna	B2
veerema	tegusõna	B2
veerg	nimisõna	B2
vehklema	tegusõna	B2
veidike	määrsõna	B2
veidrus	nimisõna	B2
veis	nimisõna	B2
velg	nimisõna	B2
venitama	tegusõna	B2
venitus	nimisõna	B2
ventilatsioon	nimisõna	B2
verbaalne	omadussõna	B2
vereringe	nimisõna	B2
veresoon	nimisõna	B2
veresuhkur	nimisõna	B2
verine	omadussõna	B2
vertikaalne	omadussõna	B2
vesikupp	nimisõna	B2
vesinik	nimisõna	B2
vesiroos	nimisõna	B2
veski	nimisõna	B2
veteran	nimisõna	B2
vetikas	nimisõna	B2
viadukt	nimisõna	B2
vibratsioon	nimisõna	B2
videvik	nimisõna	B2
vidin	nimisõna	B2
vigane	omadussõna	B2
vigastus	nimisõna	B2
vihjama	tegusõna	B2
vihje	nimisõna	B2
vihmasadu	nimisõna	B2
viht	nimisõna	B2
vihtlema	tegusõna	B2
viide	nimisõna	B2
viik	nimisõna	B2
viik	nimisõna	B2
viiking	nimisõna	B2
viilutama	tegusõna	B2
viimaks	määrsõna	B2
viimati	määrsõna	B2
viimistlema	tegusõna	B2
viimistlus	nimisõna	B2
viimne	omadussõna	B2
viipama	tegusõna	B2
viipekeel	nimisõna	B2
viirushaigus	nimisõna	B2
viisakus	nimisõna	B2
viisavabadus	nimisõna	B2
viisi	kaassõna	B2
viisnurk	nimisõna	B2
viitama	tegusõna	B2
viiuldaja	nimisõna	B2
viivitama	tegusõna	B2
viivitamata	määrsõna	B2
viivitamatult	määrsõna	B2
viivitus	nimisõna	B2
viktoriin	nimisõna	B2
vile	nimisõna	B2
viletsus	nimisõna	B2
vilistama	tegusõna	B2
vilistlane	nimisõna	B2
viljakas	omadussõna	B2
viljakus	nimisõna	B2
vilkur	nimisõna	B2
vill	nimisõna	B2
villa	nimisõna	B2
viltu	määrsõna	B2
vilunud	omadussõna	B2
vinge	omadussõna	B2
vinn	nimisõna	B2
vint	nimisõna	B2
virisema	tegusõna	B2
virtuaalne	omadussõna	B2
visa	omadussõna	B2
visalt	määrsõna	B2
vise	nimisõna	B2
visiitkaart	nimisõna	B2
visioon	nimisõna	B2
viski	nimisõna	B2
vispel	nimisõna	B2
visuaalne	omadussõna	B2
visuaalselt	määrsõna	B2
vokaal	nimisõna	B2
voldik	nimisõna	B2
voli	nimisõna	B2
volikiri	nimisõna	B2
volikogu	nimisõna	B2
volinik	nimisõna	B2
volitama	tegusõna	B2
voltima	tegusõna	B2
volüüm	nimisõna	B2
vool	nimisõna	B2
voolik	nimisõna	B2
voolima	tegusõna	B2
vormel	nimisõna	B2
vormima	tegusõna	B2
vrakk	nimisõna	B2
vulkaan	nimisõna	B2
vundament	nimisõna	B2
vutt	nimisõna	B2
võidu	määrsõna	B2
võidu	kaassõna	B2
võidujooks	nimisõna	B2
võidukas	omadussõna	B2
võidutsema	tegusõna	B2
võimaldama	tegusõna	B2
võimalikkus	nimisõna	B2
võimalikult	määrsõna	B2
võimekas	omadussõna	B2
võimekus	nimisõna	B2
võimendama	tegusõna	B2
võimetu	omadussõna	B2
võimla	nimisõna	B2
võimsalt	määrsõna	B2
võimsus	nimisõna	B2
võlakiri	nimisõna	B2
võlgnema	tegusõna	B2
võlgnevus	nimisõna	B2
võlgnik	nimisõna	B2
võlts	omadussõna	B2
võltsima	tegusõna	B2
võltsing	nimisõna	B2
võltsitud	omadussõna	B2
võluma	tegusõna	B2
võrdlemisi	määrsõna	B2
võrdsus	nimisõna	B2
võrdsustama	tegusõna	B2
võrduma	tegusõna	B2
võrdusmärk	nimisõna	B2
võrdõiguslikkus	nimisõna	B2
võrgustik	nimisõna	B2
võrra	kaassõna	B2
võrrand	nimisõna	B2
võru	nimisõna	B2
võsa	nimisõna	B2
võte	nimisõna	B2
võõrandamine	nimisõna	B2
võõrkeha	nimisõna	B2
võõrsil	määrsõna	B2
võõrustama	tegusõna	B2
väel	kaassõna	B2
väele	kaassõna	B2
väetis	nimisõna	B2
vägev	omadussõna	B2
vägisi	määrsõna	B2
vägistama	tegusõna	B2
vägivaldne	omadussõna	B2
vähegi	määrsõna	B2
vähehaaval	määrsõna	B2
väheke	nimisõna	B2
vähemasti	määrsõna	B2
vähemusrahvus	nimisõna	B2
vähesus	nimisõna	B2
vähihaige	nimisõna	B2
väide	nimisõna	B2
väidetavalt	määrsõna	B2
väiksus	nimisõna	B2
väimees	nimisõna	B2
väin	nimisõna	B2
väitekiri	nimisõna	B2
väitma	tegusõna	B2
välde	nimisõna	B2
välimine	omadussõna	B2
väliselt	määrsõna	B2
välismaailm	nimisõna	B2
välispoliitika	nimisõna	B2
välispoliitiline	omadussõna	B2
välissuhted	nimisõna	B2
välistama	tegusõna	B2
välja pressima	tegusõna	B2
välja tooma	tegusõna	B2
välja vahetama	tegusõna	B2
välja ütlema	tegusõna	B2
väljamakse	nimisõna	B2
väljamõeldis	nimisõna	B2
väljapaistev	omadussõna	B2
väljapanek	nimisõna	B2
väljaränne	nimisõna	B2
väljavaade	nimisõna	B2
väljend	nimisõna	B2
väljenduma	tegusõna	B2
väljendus	nimisõna	B2
väljendusoskus	nimisõna	B2
väljund	nimisõna	B2
vältel	kaassõna	B2
vältimatu	omadussõna	B2
väravavaht	nimisõna	B2
värbama	tegusõna	B2
värk	nimisõna	B2
värskelt	määrsõna	B2
värskendama	tegusõna	B2
värskus	nimisõna	B2
värss	nimisõna	B2
värvikas	omadussõna	B2
värvitu	omadussõna	B2
värvus	nimisõna	B2
väsitama	tegusõna	B2
väsitav	omadussõna	B2
väänama	tegusõna	B2
väär	nimisõna	B2
väär	omadussõna	B2
väärikalt	määrsõna	B2
väärikas	omadussõna	B2
vääriline	omadussõna	B2
väärisese	nimisõna	B2
vääriskivi	nimisõna	B2
väärtpaber	nimisõna	B2
väärtushinnang	nimisõna	B2
väärtustama	tegusõna	B2
vürst	nimisõna	B2
vürts	nimisõna	B2
õel	omadussõna	B2
õhkkond	nimisõna	B2
õhujõud	nimisõna	B2
õhuline	omadussõna	B2
õhutama	tegusõna	B2
õhuvägi	nimisõna	B2
õiend	nimisõna	B2
õietolm	nimisõna	B2
õige	määrsõna	B2
õigeaegne	omadussõna	B2
õigeaegselt	määrsõna	B2
õigekiri	nimisõna	B2
õiglus	nimisõna	B2
õigsus	nimisõna	B2
õigupoolest	määrsõna	B2
õigusakt	nimisõna	B2
õigusjärgne	omadussõna	B2
õiguskantsler	nimisõna	B2
õiguslik	omadussõna	B2
õigustama	tegusõna	B2
õigustus	nimisõna	B2
õis	nimisõna	B2
õng	nimisõna	B2
õpetlik	omadussõna	B2
õpinguaasta	nimisõna	B2
õpitu	nimisõna	B2
õppekava	nimisõna	B2
õppevorm	nimisõna	B2
õppur	nimisõna	B2
õudselt	määrsõna	B2
õudus	nimisõna	B2
äge	omadussõna	B2
ägenema	tegusõna	B2
ähmane	omadussõna	B2
ähvardus	nimisõna	B2
äi	nimisõna	B2
äkiline	omadussõna	B2
ämmaemand	nimisõna	B2
ära hoidma	tegusõna	B2
äratuntav	omadussõna	B2
äratus	nimisõna	B2
ärev	omadussõna	B2
äriline	omadussõna	B2
ärkamisaeg	nimisõna	B2
ärritama	tegusõna	B2
ärrituma	tegusõna	B2
ärritus	nimisõna	B2
äsja	määrsõna	B2
äsjane	omadussõna	B2
äss	nimisõna	B2
ääretult	määrsõna	B2
äärmine	omadussõna	B2
äärmus	nimisõna	B2
äärmuslane	nimisõna	B2
äärmuslik	omadussõna	B2
ökoloogiline	omadussõna	B2
ökonoomne	omadussõna	B2
ööbik	nimisõna	B2
öökülm	nimisõna	B2
ööpäevaringselt	määrsõna	B2
üha	määrsõna	B2
üheaegselt	määrsõna	B2
ühekorraga	määrsõna	B2
ühekülgne	omadussõna	B2
ühene	omadussõna	B2
ühepoolne	omadussõna	B2
ühepoolselt	määrsõna	B2
ühes	määrsõna	B2
ühes	kaassõna	B2
üheselt	määrsõna	B2
üheskoos	määrsõna	B2
ühesõnaga	määrsõna	B2
ühik	nimisõna	B2
ühiselt	määrsõna	B2
ühiskondlikult	määrsõna	B2
ühisprojekt	nimisõna	B2
ühissõiduk	nimisõna	B2
ühistu	nimisõna	B2
ühisvara	nimisõna	B2
ühte	määrsõna	B2
ühtekokku	määrsõna	B2
ühtemoodi	määrsõna	B2
ühtlaselt	määrsõna	B2
ühtlasi	määrsõna	B2
ühtlustama	tegusõna	B2
ühtmoodi	määrsõna	B2
ühtne	omadussõna	B2
ühtsus	nimisõna	B2
üksainus	omadussõna	B2
ükshaaval	määrsõna	B2
üksikasjalik	omadussõna	B2
üksikasjalikult	määrsõna	B2
üksindus	nimisõna	B2
ükski	asesõna	B2
ükskõiksus	nimisõna	B2
üksmeelne	omadussõna	B2
üksmeelselt	määrsõna	B2
üksnes	määrsõna	B2
üksus	nimisõna	B2
ülal pidama	tegusõna	B2
ülalpeetav	omadussõna	B2
ülalt	määrsõna	B2
ülane	nimisõna	B2
ülbe	omadussõna	B2
ülbus	nimisõna	B2
üldarv	nimisõna	B2
üldistama	tegusõna	B2
üldistus	nimisõna	B2
üldkasutatav	omadussõna	B2
üldlevinud	omadussõna	B2
üldpind	nimisõna	B2
üldsegi	määrsõna	B2
üldsus	nimisõna	B2
üle kuulama	tegusõna	B2
üle saama	tegusõna	B2
ülearu	määrsõna	B2
üleilmne	omadussõna	B2
ülejääk	nimisõna	B2
ülejäänud	omadussõna	B2
ülekaal	nimisõna	B2
ülekaalukalt	määrsõna	B2
ülekaalukas	omadussõna	B2
ülekaaluline	omadussõna	B2
ülekohus	nimisõna	B2
ülekoormus	nimisõna	B2
üleliia	määrsõna	B2
üleliigne	omadussõna	B2
üleloomulik	omadussõna	B2
ülem	nimisõna	B2
ülemaailmne	omadussõna	B2
üleminek	nimisõna	B2
ülemäära	määrsõna	B2
ülemäärane	omadussõna	B2
üleni	määrsõna	B2
ülepäeviti	määrsõna	B2
üles märkima	tegusõna	B2
üles ütlema	tegusõna	B2
ülesehitus	nimisõna	B2
üleskutse	nimisõna	B2
ülestunnistus	nimisõna	B2
ülestõus	nimisõna	B2
ületama	tegusõna	B2
ületamatu	omadussõna	B2
ületund	nimisõna	B2
ülevaatlik	omadussõna	B2
üleval pidama	tegusõna	B2
üleöö	määrsõna	B2
üleüldse	määrsõna	B2
ülihea	omadussõna	B2
ülikiire	omadussõna	B2
ülimalt	määrsõna	B2
ülioluline	omadussõna	B2
ülistama	tegusõna	B2
ülisuur	omadussõna	B2
üllatav	omadussõna	B2
üllatavalt	määrsõna	B2
üllatuslik	omadussõna	B2
üllatuslikult	määrsõna	B2
ümber korraldama	tegusõna	B2
ümber kujundama	tegusõna	B2
ümber lükkama	tegusõna	B2
ümber sõnastama	tegusõna	B2
ümberringi	määrsõna	B2
ümbersõit	nimisõna	B2
ümbert	määrsõna	B2
ümbert	kaassõna	B2
ümberõpe	nimisõna	B2
ümbris	nimisõna	B2
ümbruskond	nimisõna	B2
üpris	määrsõna	B2
ürgaeg	nimisõna	B2
üritama	tegusõna	B2
ürt	nimisõna	B2
ütlemata	määrsõna	B2
ütlus	nimisõna	B2
